c8I4iu7Qvyg	Bios
MWjaQcJE-xM	클라나드 1기 Opening  FULL - Megumeru
fpyGsopmUbU	「신설리/KR」 비익의 날개 - enfonius
wnX5s0hiUhY	(한글자막) 클라나드 애프터스토리 OP full - 시간을 새기는 노래 by Lia
nCISdmhD-e8	The Melancholy of Haruhi Suzumiya - Hare Hare Yukai (Full) [HD/HQ] {Ending #1}
mDW5XdGqZ9U	엔젤비트op-My Soul Your Beats[가사/발음/자막]
mSmt68_xQCs	[명곡릴레이] LiSA - 최고의보물(一番の宝物) Yui Final Ver~
YLyD37AnZzM	Toradora Orange 2 Ending Full Audio Mp3
DlePWOWlUMU	Code Geass 반역의 를르슈 OP1_Colors  (풀버전/한글자막)
RiGnxXuX1lI	Code Geass OP5 - World End 풀버전(한글자막)
s9wsRRlTL3s	Continued Story
zOzQAQiZvm0	길티크라운 1쿨 ED - Departures
1mvOx9108rU	[AMV] Steins;Gate 슈타인즈 게이트 오프닝 - Hacking to the gate (한글/일본어 자막) (스포주의)
vlwdflqDIQM	슈타인즈게이트(Steins gate) 극장판 ED - 언제나 이곳에서
XZGxkTrektA	빙과 1기 OP - 상냥함의 이유
hJUG0F0Xzrk	(한글자막) 빙과 ED 1 full - 꿈결의 약속 by 치탄다 에루 (cv : 사토 사토미), 이바라 마야카 (cv : 카야노 아이)
afW_6_Kwa_M	(한글자막) 빙과 ED 2 full - 너에 관한 미스터리 by 치탄다 에루 (cv : 사토 사토미), 이바라 마야카(cv : 카야노 아이)
nhRDmLsJHR8	사쿠라장의 애완그녀 (さくら荘のペットな彼女) ED - DAYS of DASH (한글발음, 뜻자막)
Vsz3f_0F7N4	Mobile Suit Gundam 00 ED3 Full | Chiaki Ishikawa
2OUiJRgFdPo	[좌우음향] 역시 내 청춘 러브코메디는 잘못됐다 오프닝 - 유키토키 (ユキトキ) * 이어폰, 헤드셋 *
c5tPX8HH700	역시 내 청춘 러브코메디는 잘못됐다 2기 OP - 春擬き(봄을 닮은 것) - 야나기나기(やなぎなぎ)
DXazeRIRDd0	(한글자막) 역시 내 청춘 러브코메디는 잘못됐다. 3기 (완) OP Full - 싹틈의 비 / 야나기나기
oqRqSOd7teY	Hello Alone
aszWlBugcIU	[한글자막] 내청코 2기 ED - Every day world 🎵
07s74_vSres	(한글자막) 역시 내 청춘 러브코메디는 잘못됐다. 3기 (완) ED Full - 다이아몬드의 순도 / 유키노, 유이
1SH7hLioDvQ	lull ～そして僕らは～
rD3jZeFePf8	중2병이라도 사랑이 하고싶어 OP- Sparkling daydream
EpmewXOhuDs	[ 한글자막 ] 쪼개진 사과 (割れたリン/신세계에서ed)
7p-ugBxL4yQ	[ 한글자막 ] 신세계에서 ED - 雪に咲く花 (눈에 피는꽃)
W4YbIxlfw8k	fripSide - LEVEL5-judgelight- (Audio)
Leq8J0E2TQ0	final phase
gTFeQHPLmNE	sajou no hana 『青嵐のあとで 』（Music Video）
z_eveJ_Ck8g	True Tears OP Full - Reflectia ~ Eufonius
hLa4RdxgkNM	이름없는괴물 한글자막 (Namae no nai kaibutsu
xKoCU-LPVFQ	[애니노래 추천] 사이코패스 2기 ED - Fallen (EGOIST)
wzi2rsbhcFo	사이코 패스 2쿨 ED-all alone with you 한국어 가사
BAgoiv3tDNY	Suisei no Gargantia Op - Kono Sekai wa Bokura wo Matteita (Full)
84i5Uvxoct4	Suisei no Gargantia [Ending] Full
nFG3l5zxLdM	시간을 달리는 소녀OST (변하지 않는것) 자막, 번역, 가사
QgeRmcCl0Us	東京レイヴンズ (Tokyo Ravens) - Ending Song - "Kimi ga Emu Yuugure (君が笑む夕暮れ)" by Yoshino Nanjo
1bIFKFHKdUc	[자막포함]월간순정 노자키군op-네가 아니면 안될것 같아(full 버전)
X2aNITSFMD0	NHK에 어서오세요ED 답답한 세계의 위에서
kdJY5B4EE3M	아마기 브릴리언트 파크 op full
kKYoH7O1Kdg	Rain
LVh_hUxm-0A	silky heart
y8ysAYFSVag	코드기어스반역의를르슈ED-모자이크 조각
EyRD3eG8y9s	Steins;Gate Ending (Toki Tsukasadoru Juuni no Meiyaku)
brJD1EEQ-oI	eternal reality
u3A8DhNealk	A Certain Scientific Railgun T - Ending Full | Nameless Story
-DGVVHlQm7I	Namidano Tane, Egaono Hana
lNA3-fGDDRM	4월은 너의 거짓말 op - 「빛난다면」
v2oH__JwxDM	[FMV] 4월은 너의 거짓말 OST 일곱 빛깔 심포니 _코알라모드 자막有
wKHxfrkWYiQ	4월은 너의 거짓말 ED - 오렌지 オレンジ
br82FQmioGk	4월은 너의 거짓말 『반짝임(キラメキ)』
tCcC3ByNXq0	[바라카몬 OP 자막화] Rashisa - Super Beaver
cHe54DcV3VY	山崎まさよし - One more time, One more chance (영화 초속 5센티미터 엔딩곡 MV Special Ver.) (한국어 자막)
x6-tcejfmDc	플라스틱메모리즈OP(풀버전)
4-UkTzDT5Xc	Plastic Memories ED (Full) - Asayake no Starmine
-9zu50IO7Wg	너의 색 시그널(君色シグナル) - 春奈るな/시원찮은 그녀를 위한 육성방법 op
Wilcl_qO1FQ	[좌우음향] 시원찮은 그녀의 육성방법 엔딩 -Colorful (カラフル) * 이어폰, 헤드셋 *
R9JbfZoR8Wc	흑의 계약자 2기 OP - 달빛의 이정표(테스트용)(자막)
j5fnDbWoqTY	TREASURE BOX
a2v0pvtTHQY	PLATINUM JET
kSbk58F-TjQ	Animetic Love Letter
M5qYFFbr474	Arslan Senki - Ending 1 Full
zw5wH_Tr21U	UVERworld 『僕の言葉ではない これは僕達の言葉』
mxABgqQdX7g	Kalafina - One Light
vYV-XJdzupY	Stereopony - Hitohira No Hanabira
S7fq9wg7Ywg	시도니아의 기사 - 기사행진곡(騎士行進曲)
U5-sQTSuwMA	(한글자막) 울려라! 유포니엄 1기 OP full - Dream Solister by TRUE
R0n0wa5Rm14	(한글자막) 울려라! 유포니엄 2기 OP full - 사운드스케이프 by TRUE
kXRFw6bT22k	【나만이 없는 거리 OP】 ASIAN KUNG-FU GENERATION - Re: Re: [한글자막]
z7K7SLPbyW8	사유리 - 그것은 작은 빛과 같은
XuUlYtPI6FI	[애니 OST] 아인 1기 op- 밤에는 잠들 수 있어?/[Floompool]/자막
kZH5X5K5fbg	angela「僕は僕であって」Music Clip
FKAdmgB--Yk	The end of escape -fripSide edition-
UY2dDa3c4Z0	【공식가사 PV】 Re:Zero ED::STYX HELIX(Myth & ROID) ᴴᴰ
GQ6o1SIH1rQ	[리제로]타카하시 리에 - Stay Alive
CYTnZV_NywU	잊고 싶지 않은 사람, 잊어서는 안되는 사람,  Sparkle | 너의 이름은 OST
1dJICzRip8Y	fripSide - black bullet (Audio)
stC4Uas6h7M	블랙 불릿 닫는 노래 - トコハナ(토코하나) 가사 [한국어/일본어]
VKxxy7MZMAM	ALDNOAH.ZERO OP1 Heavenly blue(한글자막)
uWJnZ8tNPsI	알드노아 제로 ED - A/Z
4gMXEd49rbg	SawanoHiroyuki[nZk] - &Z ft. mizuki
S9Fp1M2WCyU	Keep on Keeping on
mA0prO6OCE0	Genesis
W86mogpFET0	ALDNOAH ZERO OST - Harmonious
04FMa3jx0Hg	[3D입체음향] ❤‍🔥넋밤추천: Aimer - Ninelie [갑철성의 카바네리 ED]
OEjE53JjpGM	약속의 네버랜드OP 《Touch Off》-UVERworld [일어독음해석]
AIN13agbiCk	[한글자막] Sincerely - 바이올렛 에버가든 OP Full
rK9J1Cihg18	목소리의 형태 OST - 사랑을 한 것은 「恋をしたのは」
vEOrB3cf_JY	【한글가사】 LiSA - 홍련화 (紅蓮華) | 귀멸의 칼날 1기 OP
hykgx_xaNRU	귀멸의칼날ED《From the edge》-FictionJunction(feat.LiSA)[일어독음해석]
XVPK16aYaPA	【한글가사】 RADWIMPS - Grand Escape | 날씨의 아이(天気の子) OST
OpaP7wi-Wrg	몇 번이라도 너를 되찾을거야🔥: 오피셜히게단디즘 - Yesterday [Hello World OST/가사/해석/발음]
AhGMZVnfmeU	Nulbarich – Lost Game (HELLO WORLD Music Video edition)
UY2DlnI-isM	NEW WORLD
guZnyyw1euc	거꾸로 된 파테마 OST
GpovDdSC8Po	Steins;Gate VN Opening [OP] "Sky Clad Observer" by Kanako Itō [ENG SUB]
NxaudrNbvN0	(한글자막/노래방자막) 울고 싶은 나는 고양이를 뒤집어 쓴다 OST - 꽃에 망령 / 요루시카 [띵곡]
g2P_UX-R3PQ	Hello, shooting-star
-tKVN2mAKRI	DAOKO × 米津玄師『打上花火』MUSIC VIDEO
SXItubV9_k8	last impression
2e0Cdi_TLY8	Aimer - Through My Blood『Kabaneri of the Iron Fortress』
_2F1JzBVbJw	(한글자막) Re: 제로부터 시작하는 이세계 생활 1기 1쿨 OP Full - Redo / 스즈키 코노미
K5bm_ER9CKw	Paradisus-Paradoxum
Ibb9I6f0mIc	シドニアの騎士 OP シドニア
OIK-q75yrJM	강철의 연금술사 브라더후드 여는 노래 「Again」 가사 영상 [한국어/일본어]
o71vyLnNtBo	Hologram
u5-w1Bf60ls	(한글자막) 강철의 연금술사 BROTHERHOOD OP 3 full - Golden Time Lover by 스키마스위치
SpmMZx4df5Q	강철의 연금술사 리메이크 4기 OP- Period 가사
Hy8q60zzlqs	Rain - Sid +가사포함+ 강철의 연금술사 리메이크 -Fullmetar alchemist remake- opening5
sJiSqkC2YOg	SID - 嘘(강철의 연금술사 Brotherhood 1기 엔딩)
vhgAtFExcj4	Let It Out
p3BnK8-cibI	[한글자막] 강철의 연금술사 브라더후드 3 ED つないだ手 | 맞잡은 손
2kXLZ9_GwIc	Shunkan Sentimental
WAPxG8CFuO4	Ray of Light
HmfCHKeszDU	Sign
zqKrpw36xnU	Silhouette
2naPFTi0NQ8	난무의 멜로디 (블리치 13기 OP) Full
lA9_6V1Tx6M	미와 - chAngE
--Q1QMzEB6U	Don't Cry Anymore
u-V-0XQdGjA	[페이트 스테이 나이트 ED 1] Jyukai(쥬카이) - 당신이 있던 숲 가사/발음
YWM0UbcZJnc	[한글자막] Fate/Stay Night OP2 - Brave Shine
woKb_TbTrEo	Ideal White
ZK4s2hc4p6k	Kalafina - Believe (한글 번역)
KGYFyQengfA	Ring Your Bell
UqjqRMPwN-k	THIS ILLUSION
p4Bgv9B_xH8	페이트 스테이 나이트UBW OST  Aimer-LAST STARDUST
EbZxeoZBHwE	[페이트 제로 OP 1] LiSA - Oath Sign 가사/발음
J-0sZqzAHKo	페이트 제로 ed - memoria [자막, 발음]
2psgnTAVz0E	To the Beginning
91j4PyhWijo	[페이트 제로 ED 2] Luna Haruna - 하늘은 높고 바람은 노래한다 가사/발음
vd3l-7gTjVI	GUNDAM 08th team Shine in the Storm / 건담 08소대 폭풍속에서 빛나줘
ZS6e_-2PSdE	SawanoHiroyuki - Into the Sky ft. Tielle(한글자막)
AheLLqrEKn4	Next 2 U - Euc
uhXmcp2UPZo	Aimer- Re:I Am(한글자막)
7Yv7rL5kcn8	[한글가사] Chemistry - Merry go round(기동전사 건담 유니콘 OST)
cmXW3qfhT60	StarRingChild (Movie Version)
GuhtxtP0LPo	한글 자막) SawanoHiroyuki[nZk]:LiSA - narrative (기동전사 건담 NT OST)
yT0uE11gkk4	Mobile Suit Gundam Narrative-VigilaNTe(한글자막)
0e3WtCtIEHg	[한글번역] SawanoHiroyuki[nZk] - Cage (feat. Tielle)
JynqkDmhAEA	건담 SEED Invoke
8j6zFTt1FVw	Believe
iR1WQ52_dbU	Realize
Wqsoiun3pnY	Annani Issyo Dattanoni
AZegBSfZ8SQ	中島美嘉『FIND THE WAY』 MUSIC VIDEO
-wSqb_vzO28	Meteor
HlZcqD0gpeg	Akatsuki no Kuruma (piano supplement Version)
jI2sAozLwLk	Ignited
mWdKE1yyJnw	[한글자막] 기동전사 건담 SEED DESTINY OP2 | PRIDE
be3rH4YTlkk	Reason
1EzTosXoaN8	I Wanna Go To A Place...
U6BkF23UPbM	Kimi wa Boku ni Niteiru
nuxZTnJE_OE	Diver
AKXNtLwP294	Pray
3FIL4aRi6FE	Gin Iro No Sora
SnJ5Xnw4Wkk	Gintama OP2 - Tooi Nioi - Yo-King FULL HQ
_aSqhkzHtpE	A Cloudy Sky
I1VTvbGgPPQ	Pandemonium
FXppROCqu94	Some Like It Hot!!
XddBSIgryC4	wonderland
ozPtL1R6mZ8	Sakuramitsutsuki
NLVVF2Op9Zc	Pride Kakumei
k1Ey101ysL0	KNOW KNOW KNOW
Y2p3ROEijNQ	Katteni My Soul
AGne7i4gwZI	I Wanna Be...
FYyX62RMEWQ	Hikari Shoumeiron
WEoZSH_gp20	Glorious Days
_UJW6u9pwsg	Hoshi Ga Matataku Konnayoruni -Game Version
evsLwBbWrvk	Orion
0VpGoDp3FCE	Kimino Shiranai Monogatari
nusYeKN4ByE	Change
MSG4p7rMyn4	Ranbu No Melody
D2CRlGawlOI	⁴ᴷ[한글가사/해석] 너를 태우고(Carrying You/君をのせて) - 히사이시 조, 이노우에 아즈미 (천공의 성 라퓨타 OST) [일본어 발음 포함]
2OTfIElRkxg	鋼のレジスタンス(강철의 레지스탕스)
HpLOwMaxc8E	はたらく魔王さま！op  ZERO!!　full
_rH-Fb6YM7E	月花
HygVQOD8R1Y	[일본명곡] Endless tears - CLIFF EDGE 한국자막/가사/해석/발음
MGFiqGGVAuk	Aldnoah Zero -   BRE@TH／／LESS feat Mika kobayashi (OST) ***
wh11u95kimU	No Differences
ou_u8TSThhU	The Distance - Cliff Edge ft. Nakamura Maiko (lyrics)
yEgcUQvFYyk	DOGFIGHT
OzGVz1ClxIc	Snow halation
XCiDuy4mrWU	Initial D - Running in The 90s
ptUYZl0t5mA	♪. 별의 목소리 OST - Through The Years And Far Away [가사, Lyrics]
qYvIP2D_XO8	narrative (Remastered)
2B6nj38AdD0	紅蓮の弓矢
vMti19q-ov0	진격의거인 ED 아름답고도 잔혹한 세계 자막  발음 HD ver
W8UNLOOogU4	自由の翼
XV0R-5GxyyU	Name of Love
mWIaFbHG44s	great escape
8QPyFlJNmus	心臓を捧げよ！
oYQmw6axrdQ	Red Swan
wGBc7Vd6ejM	진격의 거인 3기 2쿨 op 《동경과 시체의 길》 풀버전 (자막)
h8MB492MXgE	Raise your flag
f48dPf3jWsE	Survivor
m5tYVyfb_8Q	STEEL -鉄血の絆-
PEVBOsSZkN8	Rage of Dust
ZxCSn2osKQQ	Fighter
e1EExQiRhC0	Freesia
v6vBNzYOXwU	Endless Rain
HWLIIetcILY	Super Driver
-VKIqrvVOpo	요루시카 - 그저 네게 맑아라 (MUSIC VIDEO)
F64yFFnZfkI	요루시카 - 말해줘.(Music Video)
3MCp8OUMqgE	애니음악 은혼 3기 엔딩 눈의 날개(Yuki no Tsubasa)
MF8kHWWFO10	seven oops - Lovers
KId6eunoiWk	LiSA - Crossing Field
CpDyF4pkbAs	Luna Haruna - Overfly
CSnCY_jkff0	[가사,자막] '가끔은 신나는 노래도 들어봐요' 2분의 1 - BACK-ON ( ニブンノイチ - BACK-ON )
l3xERyhSppQ	니세코이 1기 1쿨 OP Click (mp3 original)
m5BW7NGhw1k	ClariS - Step (Nisekoi Theme 2) (Audio)
VgeROmbA-nk	니세코이 2기op Rally Go Round ニセコイ2 op Rally Go Round
477jdFG4cOU	(한글자막) 울고 싶은 나는 고양이 가면을 쓴다 ED - 거짓말쟁이 / 요루시카
8NqLb6xMJkw	irony(내여귀 1기 OP) 한글자막 풀버전
Wz-pNcgYo0c	Don't say lazy [ending 1 K-on]【FULL version】~ Lyrics English - Romaji - 日本語 - 한국어 - 中文 / Sub Español
Z6BF_5p4jMY	Kill la Kill Opening 2 Full ~ • Ambiguous • ~
5Anbuz1rFFU	칸코레 애니 ED 후부키(吹雪)full버젼 한글자막
2A0Rqo7DB7U	함대 콜렉션 - 바다색 [자막]
dv13gl0a-FA	Initial D - Deja Vu
dNGiRuLABgI	aLIEz
8S74b6DW0fg	Niko / Night Of Fire 가사&번역【Lyrics/Initial D/Eurobeat/이니셜D/유로비트】
CrJSn4a2hYg	Annalise / Promised Land 가사&번역【Lyrics/Initial D/Eurobeat/이니셜D/유로비트】
KDXsZbsrHWo	Bubble (feat. Uta)
3Eo02oa0GtU	(한글자막) 여친, 빌리겠습니다 OP Full - 센티미터 / the peggies
Pb6MyDbODqM	ハナノイロ
XdczBzp9rDc	Hazy
8Lz3IwqrRV8	Kanata no Astra - Full Opening『 Star* Frost』by Nonoc
rk2HTJzs73E	Riko Azuna - Glow at the Velocity of Light
KTZ-y85Erus	요루시카 - 그래서 나는 음악을 그만두었다 (MUSIC VIDEO)
TQ8WlA2GXbk	Official髭男dism - Pretender［Official Video］
XSsIE5RvDEY	面影ワープ
bJiY39dfX4A	影踏み
q4VpnwdkPKI	夢路
2DmXi4aW4V8	Hanasaku Iroha ED 2 Full || Hanasaku Iroha - Clammbon
QcH0QS7A3fM	X-Japan Tears (가사 한글 자막)
4oX8Ih9r4oI	Bokurano OP [Uninstall - Chiaki Ishikawa - ]
bt8wNQJaKAk	Official髭男dism - I LOVE...［Official Video］
A8YZelgycBY	(한글 가사,자막,발음)불꽃소방대 OP inferno - Mrs. GREEN APPLE - インフェルノ
6YZlFdTIdzM	ONE OK ROCK - Clock Strikes [Official Music Video]
9aJVr5tTTWk	米津玄師 - ピースサイン , Kenshi Yonezu - Peace Sign
Fkeq0ZjBqJs	구름같은 다정함으로 안아줄게🌼: 아이묭 - 마리골드(marigold) [가사/발음/해석]
ynqPnb3BFbU	RPG - Sekai no Owari 가사/독음/번역
ReTZxxQ21Mg	765PRO ALLSTARS - READY!!
fGGTf044UPI	ライオン
bbSdE2lzGgs	Little Bird
Ua3nIzKiikg	「loser」-  요네즈켄시(米津玄師) (일본어 자막 / 한국어 자막/ 일본어 발음)
RA1JSWTOMC0	Vermillion
ZGM90Bo3zH0	Steins;Gate Opening Theme - Hacking to the Gate (Full Version)
8ZuE9Twti8I	Tsunagu kizuna yosuga no sora ending sub esp
5QNaSMiZ_-o	God knows...
kLWEViLhnM4	【HD】凪のあすから OP2 -  ebb and flow【中+日+羅馬字幕】
ixQp5kvW_Tw	Ending: Nagi no Asukara (1) Lyrics
FKwXsK-BO2Y	SawanoHiroyuki[nZk] - Avid(한글자막)
h7digACgKDY	Driver's high gto Opening
xZdVDoUWxDA	윤하, 혜성[Younha, ほうき星] 일본어/발음/한국어
yPda5TYLE3o	Heavenly Blue
XZBc0G6hCmQ	Ichibanka
1dIFMIhkNQc	Prover
Ba0fGAYDQLE	星が降るユメ
puoP1AMNlNY	【가사/해석】 RADWIMPS - 최대공약수(最大公約数)
3KGjAw0fGX0	UNISON SQUARE GARDEN「Phantom Joke」MV
ri2VCCTg7SM	【 HD 】Tell me (Fate / Grand Order 절대마수 전선 바빌로니아 ED3 ) - milet - 【韓日字幕 / 한일자막】
bSRq2IxGpyw	『Pray』Nana Mizuki 歌ってみた
emGzixIiJ6k	Kasanova - Love shining
Zer6dhT-z7M	[한글가사] Grand Blue(그랑블루 오프닝) - 쇼난노카제(湘南乃風) 자막/번역
zG0JxmQmg3w	Yakudo
CXDUXjsU5ao	Staple Stable
XfjOSXQm5Eo	Irony
Yqz_G25CjrE	Step
Rbgw_rduQpM	I Really Want to Stay at Your House
T_iLqam_f4E	Mirai
dmib40Usy20	Seimeisen
b_bjtIeqIR4	Wataridori
Po2Ujyn8SXE	Harunohi
HHWdW42aJtE	지금에서야 네가 생각나🌧: 아타라요 - 여름 안개(夏霞) [가사/발음/한글 자막/해석]
WmZQFfypvhg	My Dearest
-p0IjnBhG10	The Everlasting Guilty Crown
3LjKx9Ikp8w	Ray「ebb and flow」Official Music Video/Full Size（TVアニメ「凪のあすから」新OPテーマ）
C9vAUfSEh8Q	BUMP OF CHICKEN「SOUVENIR」
E9Dru15yq9w	yama『色彩』MV（TVアニメ「SPYxFAMILY」第2クールエンディング主題歌）
ihhdNqG32cw	[직키픽🔥🔥] 너는 록을 듣지 않아: あいみょん(Aimyon) - 君はロックを聴かない (Kimi Wa Rock Wo Kikanai) (2017) [가사해석/번역]
sVEc3XmaLvc	[한글자막] 파티피플 공명 OP Full - 치키치키 밤밤(チキチキバンバン, Chitty Chitty Bang Bang) │ QUEENDOM
NlH2pvi2udo	[한글자막] 리코리스 리코일 ED Full - 꽃의 탑(花の塔) ) │ 사유리(さユり)
bqpEAIVqT6M	SHUFFLE! OP 「YOU」
jKTC6TpvZfQ	탐정은 이미 죽었다 OP : 메아리, jon-YAKITORY / 여기에 살아있어 / 한국어 자막
UycYDDRF2qA	히카루의 바둑 ED - Get Over(일어판, 자막)
wXiCbXD42AI	[한글자막] 야마다와 7명의 마녀 OP くちづけDiamond | 입맞춤 다이아몬드
V6bH5H3ZPII	Butterfly Kiss Rave Master OP
sTi-9tFG-6g	Driver's High
pJ-1-jokFZ4	[한글자막] 문호 스트레이독스 1기 1쿨 ED 名前を呼ぶよ | 이름을 부를게
ptnYBctoexk	米津玄師  - 馬と鹿   Kenshi Yonezu - Uma to Shika
_ym-MQ5PINA	[한글자막] 듀라라라 1기 2쿨 OP コンプリケイション | Complication
4rtzeD6cuuk	[가사,자막] '블랙잭 OP' 월광화 - 잔 다르크 / 月光花 - Janne Da Arc
SVkGRoLicuA	Sukidakara
y07N6neDYQ8	[샤를로트] ED - 불타 떨어지지 않는 날개 Full ver.
iYBk5eevAeQ	Ushinawareta mirai wo motomete opening lyrics
oT88I70T6Cw	残酷な天使のテーゼ
PtA879q09P4	Senkou
5g-glh0eTYY	765PRO ALLSTARS - READY!! [Official Audio]
hrfnpTGUfmg	💫가슴 벅차오르는 노래 1위 : Yuuri - BETELGEUSE (베텔기우스) [가사/해석/lyrics]
lzyDD8bMDKs	【MV】팬서비스／mona(CV：나츠카와 시이나)【HoneyWorks】
gBUp_QKfyLg	Hands Up to the Sky
RuCB-3YavxA	only my railgun
3bR31p1cPqU	sister's noise
cr4k_OUosfE	Get Over
HkQ_mzbC_WY	Complication
udNgJUiBCRg	Blue Bird
R5nefAZbkrs	Stand Still - 井口裕香
PDSkFeMVNFs	RADWIMPS - 前前前世 (movie ver.) [Official Music Video]
SX_ViT4Ra7k	米津玄師  - Lemon  Kenshi Yonezu
TCoZoL2RFOU	SPACE BOY
FIsTQ1UrWhM	Max Coveri / Golden Age 가사&번역【Lyrics/Initial D/Eurobeat/이니셜D/유로비트】
VJdrglUPjw4	DUSTCELL - 過去の蜃気楼 / Mirage Of The Past
yYAgBRO-aT8	【荒木哲郎×SawanoHiroyuki[nZk]：Hata Motohiro】『COLORs』／TOHO animation ミュージックフィルムズ
HFtn3y77Vs0	BETELGEUSE
BLqH4O7zq0s	After Rain (Scarlet Version)
MtLHwqbE1eI	Dream lantern
_2etUuScYgE	i-mage
4BxUlO0sUt8	花笑む
ade1Z0s2-Fs	Daisy
ry3Tupx4BL4	요루시카 - 퍼레이드 (MUSIC VIDEO)
XdYPdQcXz6E	Starry
aLTQmyIGoXg	雪解け (feat. 倚水)
UN0WgANuWPo	DAYBREAK FRONTLINE
wPCO-7xW9WI	Shizuku
uvDQbUTIK2k	또 다시 너와의 첫키스를 원해💋: 스다 마사키 - 사요나라 엘레지(さよならエレジー) [가사/발음/한글 해석]
h7GnR191_us	[한글자막]宇多田ヒカル(우타다 히카루)-One last kiss
BN1ofrqIl9I	Blue Spring and Western Sky
cPXWH8OXWmc	봇치 더 락! - 별자리가 될 수 있다면 한글 자막
Im7-2qRc38A	기타와 고독과 푸른 행성 | 가사, 발음
E5O0mCrUdAM	Rockn' Roll, Morning Light Falls on You
8Selo-P1Ovc	Never forget


333