c8I4iu7Qvyg	Bios
MWjaQcJE-xM	í´ë¼ë‚˜ë“œ 1ê¸° Opening  FULL - Megumeru
fpyGsopmUbU	ã€Œì‹ ì„¤ë¦¬/KRã€ ë¹„ìµì˜ ë‚ ê°œ - enfonius
wnX5s0hiUhY	(í•œê¸€ìë§‰) í´ë¼ë‚˜ë“œ ì• í”„í„°ìŠ¤í† ë¦¬ OP full - ì‹œê°„ì„ ìƒˆê¸°ëŠ” ë…¸ë˜ by Lia
v2Lc5Wne9fQ	(í•œê¸€ìë§‰) ê·¸ë‚  ë³¸ ê½ƒì˜ ì´ë¦„ì„ ìš°ë¦¬ëŠ” ì•„ì§ ëª¨ë¥¸ë‹¤ OP full - í‘¸ë¥¸ ì±…ê°ˆí”¼ by Galileo Galilei
nCISdmhD-e8	The Melancholy of Haruhi Suzumiya - Hare Hare Yukai (Full) [HD/HQ] {Ending #1}
mDW5XdGqZ9U	ì—”ì ¤ë¹„íŠ¸op-My Soul Your Beats[ê°€ì‚¬/ìë§‰/ë°œìŒ]
mSmt68_xQCs	[ëª…ê³¡ë¦´ë ˆì´] LiSA - ìµœê³ ì˜ë³´ë¬¼(ä¸€ç•ªã®å®ç‰©) Yui Final Ver~
YLyD37AnZzM	Toradora Orange 2 Ending Full Audio Mp3
DlePWOWlUMU	Code Geass ë°˜ì—­ì˜ ë¥¼ë¥´ìŠˆ OP1_Colors  (í’€ë²„ì „/í•œê¸€ìë§‰)
RiGnxXuX1lI	Code Geass OP5 - World End í’€ë²„ì „(í•œê¸€ìë§‰)
s9wsRRlTL3s	Continued Story
zOzQAQiZvm0	ê¸¸í‹°í¬ë¼ìš´ 1ì¿¨ ED - Departures
1mvOx9108rU	[AMV] Steins;Gate ìŠˆíƒ€ì¸ì¦ˆ ê²Œì´íŠ¸ ì˜¤í”„ë‹ - Hacking to the gate (í•œê¸€/ì¼ë³¸ì–´ ìë§‰) (ìŠ¤í¬ì£¼ì˜)
vlwdflqDIQM	ìŠˆíƒ€ì¸ì¦ˆê²Œì´íŠ¸(Steins gate) ê·¹ì¥íŒ ED - ì–¸ì œë‚˜ ì´ê³³ì—ì„œ
XZGxkTrektA	ë¹™ê³¼ 1ê¸° OP - ìƒëƒ¥í•¨ì˜ ì´ìœ 
hJUG0F0Xzrk	(í•œê¸€ìë§‰) ë¹™ê³¼ ED 1 full - ê¿ˆê²°ì˜ ì•½ì† by ì¹˜íƒ„ë‹¤ ì—ë£¨ (cv : ì‚¬í†  ì‚¬í† ë¯¸), ì´ë°”ë¼ ë§ˆì•¼ì¹´ (cv : ì¹´ì•¼ë…¸ ì•„ì´)
afW_6_Kwa_M	(í•œê¸€ìë§‰) ë¹™ê³¼ ED 2 full - ë„ˆì— ê´€í•œ ë¯¸ìŠ¤í„°ë¦¬ by ì¹˜íƒ„ë‹¤ ì—ë£¨ (cv : ì‚¬í†  ì‚¬í† ë¯¸), ì´ë°”ë¼ ë§ˆì•¼ì¹´(cv : ì¹´ì•¼ë…¸ ì•„ì´)
nhRDmLsJHR8	ì‚¬ì¿ ë¼ì¥ì˜ ì• ì™„ê·¸ë…€ (ã•ãã‚‰è˜ã®ãƒšãƒƒãƒˆãªå½¼å¥³) ED - DAYS of DASH (í•œê¸€ë°œìŒ, ëœ»ìë§‰)
hkvk9pNJ87Q	ã€HDã€‘æ©Ÿå‹•æˆ°å£«é‹¼å½ˆ00 Mobile Suit Gundam 00 OP1 - L'Arc~en~Ciel - DAYBREAK'S BELLã€ä¸­æ—¥å­—å¹•ã€‘
_p_H7OcDOyw	ã€HDã€‘æ©Ÿå‹•æˆ°å£«é‹¼å½ˆ00 Mobile Suit Gundam 00 OP3 - UVERworld - å„šãã‚‚æ°¸ä¹…ã®ã‚«ãƒŠã‚·ã€ä¸­æ—¥å­—å¹•ã€‘
l4ZLQJgv-Q8	ã€HDã€‘æ©Ÿå‹•æˆ°å£«é‹¼å½ˆ00 Mobile Suit Gundam 00 OP2 - the brilliant green - Ash Like Snowã€ä¸­æ—¥å­—å¹•ã€‘
cEkCFEBWND8	ã€HDã€‘æ©Ÿå‹•æˆ°å£«é‹¼å½ˆ00 Mobile Suit Gundam 00 OP4 - ã‚¹ãƒ†ãƒ¬ã‚ªãƒãƒ‹ãƒ¼ - æ³ªã®ãƒ ã‚³ã‚¦ã€ä¸­æ—¥å­—å¹•ã€‘
nD9LwQHc1ik	ã€HDã€‘æ©Ÿå‹•æˆ°å£«é‹¼å½ˆ00 Mobile Suit Gundam 00 ED2 - Stephanie - ãƒ•ãƒ¬ãƒ³ã‚ºã€ä¸­æ—¥å­—å¹•ã€‘
Vsz3f_0F7N4	Mobile Suit Gundam 00 ED3 Full | Chiaki Ishikawa
j8aecF5HXm4	ã€HDã€‘æ©Ÿå‹•æˆ°å£«é‹¼å½ˆ00 Mobile Suit Gundam 00 ED4 - ä¼Šè—¤ç”±å¥ˆ - trust youã€ä¸­æ—¥å­—å¹•ã€‘
2OUiJRgFdPo	[ì¢Œìš°ìŒí–¥] ì—­ì‹œ ë‚´ ì²­ì¶˜ ëŸ¬ë¸Œì½”ë©”ë””ëŠ” ì˜ëª»ëë‹¤ ì˜¤í”„ë‹ - ìœ í‚¤í† í‚¤ (ãƒ¦ã‚­ãƒˆã‚­) * ì´ì–´í°, í—¤ë“œì…‹ *
c5tPX8HH700	ì—­ì‹œ ë‚´ ì²­ì¶˜ ëŸ¬ë¸Œì½”ë©”ë””ëŠ” ì˜ëª»ëë‹¤ 2ê¸° OP - æ˜¥æ“¬ã(ë´„ì„ ë‹®ì€ ê²ƒ) - ì•¼ë‚˜ê¸°ë‚˜ê¸°(ã‚„ãªããªã)
DXazeRIRDd0	(í•œê¸€ìë§‰) ì—­ì‹œ ë‚´ ì²­ì¶˜ ëŸ¬ë¸Œì½”ë©”ë””ëŠ” ì˜ëª»ëë‹¤. 3ê¸° (ì™„) OP Full - ì‹¹í‹ˆì˜ ë¹„ / ì•¼ë‚˜ê¸°ë‚˜ê¸°
oqRqSOd7teY	Hello Alone
aszWlBugcIU	[í•œê¸€ìë§‰] ë‚´ì²­ì½” 2ê¸° ED - Every day world ğŸµ
07s74_vSres	(í•œê¸€ìë§‰) ì—­ì‹œ ë‚´ ì²­ì¶˜ ëŸ¬ë¸Œì½”ë©”ë””ëŠ” ì˜ëª»ëë‹¤. 3ê¸° (ì™„) ED Full - ë‹¤ì´ì•„ëª¬ë“œì˜ ìˆœë„ / ìœ í‚¤ë…¸, ìœ ì´
1SH7hLioDvQ	lull ï½ãã—ã¦åƒ•ã‚‰ã¯ï½
rD3jZeFePf8	ì¤‘2ë³‘ì´ë¼ë„ ì‚¬ë‘ì´ í•˜ê³ ì‹¶ì–´ OP- Sparkling daydream
EpmewXOhuDs	[ í•œê¸€ìë§‰ ] ìª¼ê°œì§„ ì‚¬ê³¼ (å‰²ã‚ŒãŸãƒªãƒ³/ì‹ ì„¸ê³„ì—ì„œed)
7p-ugBxL4yQ	[ í•œê¸€ìë§‰ ] ì‹ ì„¸ê³„ì—ì„œ ED - é›ªã«å’²ãèŠ± (ëˆˆì— í”¼ëŠ”ê½ƒ)
W4YbIxlfw8k	fripSide - LEVEL5-judgelight- (Audio)
Leq8J0E2TQ0	final phase
gTFeQHPLmNE	sajou no hana ã€é’åµã®ã‚ã¨ã§ ã€ï¼ˆMusic Videoï¼‰
z_eveJ_Ck8g	True Tears OP Full - Reflectia ~ Eufonius
hLa4RdxgkNM	ì´ë¦„ì—†ëŠ”ê´´ë¬¼ í•œê¸€ìë§‰ (Namae no nai kaibutsu
xKoCU-LPVFQ	[ì• ë‹ˆë…¸ë˜ ì¶”ì²œ] ì‚¬ì´ì½”íŒ¨ìŠ¤ 2ê¸° ED - Fallen (EGOIST)
wzi2rsbhcFo	ì‚¬ì´ì½” íŒ¨ìŠ¤ 2ì¿¨ ED-all alone with you í•œêµ­ì–´ ê°€ì‚¬
BAgoiv3tDNY	Suisei no Gargantia Op - Kono Sekai wa Bokura wo Matteita (Full)
84i5Uvxoct4	Suisei no Gargantia [Ending] Full
nFG3l5zxLdM	ì‹œê°„ì„ ë‹¬ë¦¬ëŠ” ì†Œë…€OST (ë³€í•˜ì§€ ì•ŠëŠ”ê²ƒ) ìë§‰, ë²ˆì—­, ê°€ì‚¬
QgeRmcCl0Us	æ±äº¬ãƒ¬ã‚¤ãƒ´ãƒ³ã‚º (Tokyo Ravens) - Ending Song - "Kimi ga Emu Yuugure (å›ãŒç¬‘ã‚€å¤•æš®ã‚Œ)" by Yoshino Nanjo
1bIFKFHKdUc	[ìë§‰í¬í•¨]ì›”ê°„ìˆœì • ë…¸ìí‚¤êµ°op-ë„¤ê°€ ì•„ë‹ˆë©´ ì•ˆë ê²ƒ ê°™ì•„(full ë²„ì „)
X2aNITSFMD0	NHKì— ì–´ì„œì˜¤ì„¸ìš”ED ë‹µë‹µí•œ ì„¸ê³„ì˜ ìœ„ì—ì„œ
kdJY5B4EE3M	ì•„ë§ˆê¸° ë¸Œë¦´ë¦¬ì–¸íŠ¸ íŒŒí¬ op full
kKYoH7O1Kdg	Rain
LVh_hUxm-0A	silky heart
y8ysAYFSVag	ì½”ë“œê¸°ì–´ìŠ¤ë°˜ì—­ì˜ë¥¼ë¥´ìŠˆED-ëª¨ìì´í¬ ì¡°ê°
EyRD3eG8y9s	Steins;Gate Ending (Toki Tsukasadoru Juuni no Meiyaku)
brJD1EEQ-oI	eternal reality
u3A8DhNealk	A Certain Scientific Railgun T - Ending Full | Nameless Story
-DGVVHlQm7I	Namidano Tane, Egaono Hana
lNA3-fGDDRM	4ì›”ì€ ë„ˆì˜ ê±°ì§“ë§ op - ã€Œë¹›ë‚œë‹¤ë©´ã€
v2oH__JwxDM	[FMV] 4ì›”ì€ ë„ˆì˜ ê±°ì§“ë§ OST ì¼ê³± ë¹›ê¹” ì‹¬í¬ë‹ˆ _ì½”ì•Œë¼ëª¨ë“œ ìë§‰æœ‰
wKHxfrkWYiQ	4ì›”ì€ ë„ˆì˜ ê±°ì§“ë§ ED - ì˜¤ë Œì§€ ã‚ªãƒ¬ãƒ³ã‚¸
br82FQmioGk	4ì›”ì€ ë„ˆì˜ ê±°ì§“ë§ ã€ë°˜ì§ì„(ã‚­ãƒ©ãƒ¡ã‚­)ã€
tCcC3ByNXq0	[ë°”ë¼ì¹´ëª¬ OP ìë§‰í™”] Rashisa - Super Beaver
cHe54DcV3VY	å±±å´ã¾ã•ã‚ˆã— - One more time, One more chance (ì˜í™” ì´ˆì† 5ì„¼í‹°ë¯¸í„° ì—”ë”©ê³¡ MV Special Ver.) (í•œêµ­ì–´ ìë§‰)
x6-tcejfmDc	í”Œë¼ìŠ¤í‹±ë©”ëª¨ë¦¬ì¦ˆOP(í’€ë²„ì „)
4-UkTzDT5Xc	Plastic Memories ED (Full) - Asayake no Starmine
-9zu50IO7Wg	ë„ˆì˜ ìƒ‰ ì‹œê·¸ë„(å›è‰²ã‚·ã‚°ãƒŠãƒ«) - æ˜¥å¥ˆã‚‹ãª/ì‹œì›ì°®ì€ ê·¸ë…€ë¥¼ ìœ„í•œ ìœ¡ì„±ë°©ë²• op
Wilcl_qO1FQ	[ì¢Œìš°ìŒí–¥] ì‹œì›ì°®ì€ ê·¸ë…€ì˜ ìœ¡ì„±ë°©ë²• ì—”ë”© -Colorful (ã‚«ãƒ©ãƒ•ãƒ«) * ì´ì–´í°, í—¤ë“œì…‹ *
R9JbfZoR8Wc	í‘ì˜ ê³„ì•½ì 2ê¸° OP - ë‹¬ë¹›ì˜ ì´ì •í‘œ(í…ŒìŠ¤íŠ¸ìš©)(ìë§‰)
JZ5Ktf_mVu0	COLORFUL BOX
j5fnDbWoqTY	TREASURE BOX
a2v0pvtTHQY	PLATINUM JET
kSbk58F-TjQ	Animetic Love Letter
M5qYFFbr474	Arslan Senki - Ending 1 Full
zw5wH_Tr21U	UVERworld ã€åƒ•ã®è¨€è‘‰ã§ã¯ãªã„ ã“ã‚Œã¯åƒ•é”ã®è¨€è‘‰ã€
mxABgqQdX7g	Kalafina - One Light
vYV-XJdzupY	Stereopony - Hitohira No Hanabira
S7fq9wg7Ywg	ì‹œë„ë‹ˆì•„ì˜ ê¸°ì‚¬ - ê¸°ì‚¬í–‰ì§„ê³¡(é¨å£«è¡Œé€²æ›²)
U5-sQTSuwMA	(í•œê¸€ìë§‰) ìš¸ë ¤ë¼! ìœ í¬ë‹ˆì—„ 1ê¸° OP full - Dream Solister by TRUE
R0n0wa5Rm14	(í•œê¸€ìë§‰) ìš¸ë ¤ë¼! ìœ í¬ë‹ˆì—„ 2ê¸° OP full - ì‚¬ìš´ë“œìŠ¤ì¼€ì´í”„ by TRUE
kXRFw6bT22k	ã€ë‚˜ë§Œì´ ì—†ëŠ” ê±°ë¦¬ OPã€‘ ASIAN KUNG-FU GENERATION - Re: Re: [í•œê¸€ìë§‰]
z7K7SLPbyW8	ì‚¬ìœ ë¦¬ - ê·¸ê²ƒì€ ì‘ì€ ë¹›ê³¼ ê°™ì€
XuUlYtPI6FI	[ì• ë‹ˆ OST] ì•„ì¸ 1ê¸° op- ë°¤ì—ëŠ” ì ë“¤ ìˆ˜ ìˆì–´?/[Floompool]/ìë§‰
kZH5X5K5fbg	angelaã€Œåƒ•ã¯åƒ•ã§ã‚ã£ã¦ã€Music Clip
FKAdmgB--Yk	The end of escape -fripSide edition-
UY2dDa3c4Z0	ã€ê³µì‹ê°€ì‚¬ PVã€‘ Re:Zero ED::STYX HELIX(Myth & ROID) á´´á´°
GQ6o1SIH1rQ	[ë¦¬ì œë¡œ]íƒ€ì¹´í•˜ì‹œ ë¦¬ì— - Stay Alive
CYTnZV_NywU	Sparkle | ë„ˆì˜ ì´ë¦„ì€ OST
1dJICzRip8Y	fripSide - black bullet (Audio)
stC4Uas6h7M	ë¸”ë™ ë¶ˆë¦¿ ë‹«ëŠ” ë…¸ë˜ - ãƒˆã‚³ãƒãƒŠ(í† ì½”í•˜ë‚˜) ê°€ì‚¬ [í•œêµ­ì–´/ì¼ë³¸ì–´]
VKxxy7MZMAM	ALDNOAH.ZERO OP1 Heavenly blue(í•œê¸€ìë§‰)
uWJnZ8tNPsI	ì•Œë“œë…¸ì•„ ì œë¡œ ED - A/Z
4gMXEd49rbg	SawanoHiroyuki[nZk] - &Z ft. mizuki
S9Fp1M2WCyU	Keep on Keeping on
mA0prO6OCE0	Genesis
W86mogpFET0	ALDNOAH ZERO OST - Harmonious
04FMa3jx0Hg	[3Dì…ì²´ìŒí–¥] â¤â€ğŸ”¥ë„‹ë°¤ì¶”ì²œ: Aimer - Ninelie [ê°‘ì² ì„±ì˜ ì¹´ë°”ë„¤ë¦¬ ED]
OEjE53JjpGM	ì•½ì†ì˜ ë„¤ë²„ëœë“œOP ã€ŠTouch Offã€‹-UVERworld [ì¼ì–´ë…ìŒí•´ì„]
AIN13agbiCk	[í•œê¸€ìë§‰] Sincerely - ë°”ì´ì˜¬ë › ì—ë²„ê°€ë“  OP Full
rK9J1Cihg18	ëª©ì†Œë¦¬ì˜ í˜•íƒœ OST - ì‚¬ë‘ì„ í•œ ê²ƒì€ ã€Œæ‹ã‚’ã—ãŸã®ã¯ã€
vEOrB3cf_JY	ã€í•œê¸€ê°€ì‚¬ã€‘ LiSA - í™ë ¨í™” (ç´…è“®èŠ±) | ê·€ë©¸ì˜ ì¹¼ë‚  1ê¸° OP
hykgx_xaNRU	ê·€ë©¸ì˜ì¹¼ë‚ EDã€ŠFrom the edgeã€‹-FictionJunction(feat.LiSA)[ì¼ì–´ë…ìŒí•´ì„]
XVPK16aYaPA	ã€í•œê¸€ê°€ì‚¬ã€‘ RADWIMPS - Grand Escape | ë‚ ì”¨ì˜ ì•„ì´(å¤©æ°—ã®å­) OST
OpaP7wi-Wrg	ëª‡ ë²ˆì´ë¼ë„ ë„ˆë¥¼ ë˜ì°¾ì„ê±°ì•¼ğŸ”¥: ì˜¤í”¼ì…œíˆê²Œë‹¨ë””ì¦˜ - Yesterday [Hello World OST/ê°€ì‚¬/í•´ì„/ë°œìŒ]
AhGMZVnfmeU	Nulbarich â€“ Lost Game (HELLO WORLD Music Video edition)
UY2DlnI-isM	NEW WORLD
guZnyyw1euc	ê±°ê¾¸ë¡œ ëœ íŒŒí…Œë§ˆ OST
GpovDdSC8Po	Steins;Gate VN Opening [OP] "Sky Clad Observer" by Kanako ItÅ [ENG SUB]
NxaudrNbvN0	(í•œê¸€ìë§‰/ë…¸ë˜ë°©ìë§‰) ìš¸ê³  ì‹¶ì€ ë‚˜ëŠ” ê³ ì–‘ì´ë¥¼ ë’¤ì§‘ì–´ ì“´ë‹¤ OST - ê½ƒì— ë§ë ¹ / ìš”ë£¨ì‹œì¹´ [ëµê³¡]
g2P_UX-R3PQ	Hello, shooting-star
-tKVN2mAKRI	DAOKO Ã— ç±³æ´¥ç„å¸«ã€æ‰“ä¸ŠèŠ±ç«ã€MUSIC VIDEO
SXItubV9_k8	last impression
2e0Cdi_TLY8	Aimer - Through My Bloodã€Kabaneri of the Iron Fortressã€
_2F1JzBVbJw	(í•œê¸€ìë§‰) Re: ì œë¡œë¶€í„° ì‹œì‘í•˜ëŠ” ì´ì„¸ê³„ ìƒí™œ 1ê¸° 1ì¿¨ OP Full - Redo / ìŠ¤ì¦ˆí‚¤ ì½”ë…¸ë¯¸
K5bm_ER9CKw	Paradisus-Paradoxum
Ibb9I6f0mIc	ã‚·ãƒ‰ãƒ‹ã‚¢ã®é¨å£« OP ã‚·ãƒ‰ãƒ‹ã‚¢
OIK-q75yrJM	ê°•ì² ì˜ ì—°ê¸ˆìˆ ì‚¬ ë¸Œë¼ë”í›„ë“œ ì—¬ëŠ” ë…¸ë˜ ã€ŒAgainã€ ê°€ì‚¬ ì˜ìƒ [í•œêµ­ì–´/ì¼ë³¸ì–´]
o71vyLnNtBo	Hologram
u5-w1Bf60ls	(í•œê¸€ìë§‰) ê°•ì² ì˜ ì—°ê¸ˆìˆ ì‚¬ BROTHERHOOD OP 3 full - Golden Time Lover by ìŠ¤í‚¤ë§ˆìŠ¤ìœ„ì¹˜
SpmMZx4df5Q	ê°•ì² ì˜ ì—°ê¸ˆìˆ ì‚¬ ë¦¬ë©”ì´í¬ 4ê¸° OP- Period ê°€ì‚¬
Hy8q60zzlqs	Rain - Sid +ê°€ì‚¬í¬í•¨+ ê°•ì² ì˜ ì—°ê¸ˆìˆ ì‚¬ ë¦¬ë©”ì´í¬ -Fullmetar alchemist remake- opening5
sJiSqkC2YOg	SID - å˜˜(ê°•ì² ì˜ ì—°ê¸ˆìˆ ì‚¬ Brotherhood 1ê¸° ì—”ë”©)
vhgAtFExcj4	Let It Out
p3BnK8-cibI	[í•œê¸€ìë§‰] ê°•ì² ì˜ ì—°ê¸ˆìˆ ì‚¬ ë¸Œë¼ë”í›„ë“œ 3 ED ã¤ãªã„ã æ‰‹ | ë§ì¡ì€ ì†
2kXLZ9_GwIc	Shunkan Sentimental
WAPxG8CFuO4	Ray of Light
HmfCHKeszDU	Sign
zqKrpw36xnU	Silhouette
2naPFTi0NQ8	ë‚œë¬´ì˜ ë©œë¡œë”” (ë¸”ë¦¬ì¹˜ 13ê¸° OP) Full
lA9_6V1Tx6M	ë¯¸ì™€ - chAngE
--Q1QMzEB6U	Don't Cry Anymore
u-V-0XQdGjA	[í˜ì´íŠ¸ ìŠ¤í…Œì´ ë‚˜ì´íŠ¸ ED 1] Jyukai(ì¥¬ì¹´ì´) - ë‹¹ì‹ ì´ ìˆë˜ ìˆ² ê°€ì‚¬/ë°œìŒ
YWM0UbcZJnc	[í•œê¸€ìë§‰] Fate/Stay Night OP2 - Brave Shine
woKb_TbTrEo	Ideal White
ZK4s2hc4p6k	Kalafina - Believe (í•œê¸€ ë²ˆì—­)
KGYFyQengfA	Ring Your Bell
UqjqRMPwN-k	THIS ILLUSION
p4Bgv9B_xH8	í˜ì´íŠ¸ ìŠ¤í…Œì´ ë‚˜ì´íŠ¸UBW OST  Aimer-LAST STARDUST
EbZxeoZBHwE	[í˜ì´íŠ¸ ì œë¡œ OP 1] LiSA - Oath Sign ê°€ì‚¬/ë°œìŒ
J-0sZqzAHKo	í˜ì´íŠ¸ ì œë¡œ ed - memoria [ìë§‰, ë°œìŒ]
2psgnTAVz0E	To the Beginning
91j4PyhWijo	[í˜ì´íŠ¸ ì œë¡œ ED 2] Luna Haruna - í•˜ëŠ˜ì€ ë†’ê³  ë°”ëŒì€ ë…¸ë˜í•œë‹¤ ê°€ì‚¬/ë°œìŒ
iIvqKBqsf6E	ã€HDã€‘Fate/stay night [Heaven's Feel] III.Spring Song - Aimer - ë´„ì€ ê°„ë‹¤
vd3l-7gTjVI	GUNDAM 08th team Shine in the Storm / ê±´ë‹´ 08ì†ŒëŒ€ í­í’ì†ì—ì„œ ë¹›ë‚˜ì¤˜
ZS6e_-2PSdE	SawanoHiroyuki - Into the Sky ft. Tielle(í•œê¸€ìë§‰)
AheLLqrEKn4	Next 2 U - Euc
uhXmcp2UPZo	Aimer- Re:I Am(í•œê¸€ìë§‰)
7Yv7rL5kcn8	[í•œê¸€ê°€ì‚¬] Chemistry - Merry go round(ê¸°ë™ì „ì‚¬ ê±´ë‹´ ìœ ë‹ˆì½˜ OST)
cmXW3qfhT60	StarRingChild (Movie Version)
GuhtxtP0LPo	í•œê¸€ ìë§‰) SawanoHiroyuki[nZk]:LiSA - narrative (ê¸°ë™ì „ì‚¬ ê±´ë‹´ NT OST)
yT0uE11gkk4	Mobile Suit Gundam Narrative-VigilaNTe(í•œê¸€ìë§‰)
0e3WtCtIEHg	[í•œê¸€ë²ˆì—­] SawanoHiroyuki[nZk] - Cage (feat. Tielle)
JynqkDmhAEA	ê±´ë‹´ SEED Invoke
Zer1k4bX65w	ä¸­æ—¥å­—å¹•ï½œæ©Ÿå‹•æˆ°å£«é‹¼å½ˆSEEDï½œOP2ï½œå®Œæ•´ç‰ˆï½œmoment
8j6zFTt1FVw	Believe
iR1WQ52_dbU	Realize
Wqsoiun3pnY	Annani Issyo Dattanoni
AZegBSfZ8SQ	ä¸­å³¶ç¾å˜‰ã€FIND THE WAYã€ MUSIC VIDEO
-wSqb_vzO28	Meteor
HlZcqD0gpeg	Akatsuki no Kuruma (piano supplement Version)
jI2sAozLwLk	Ignited
mWdKE1yyJnw	[í•œê¸€ìë§‰] ê¸°ë™ì „ì‚¬ ê±´ë‹´ SEED DESTINY OP2 | PRIDE
be3rH4YTlkk	Reason
aKiyVqmDxAI	Life Goes On
1EzTosXoaN8	I Wanna Go To A Place...
U6BkF23UPbM	Kimi wa Boku ni Niteiru
nuxZTnJE_OE	Diver
AKXNtLwP294	Pray
3FIL4aRi6FE	Gin Iro No Sora
SnJ5Xnw4Wkk	Gintama OP2 - Tooi Nioi - Yo-King FULL HQ
_aSqhkzHtpE	A Cloudy Sky
I1VTvbGgPPQ	Pandemonium
FXppROCqu94	Some Like It Hot!!
XddBSIgryC4	wonderland
ozPtL1R6mZ8	Sakuramitsutsuki
NLVVF2Op9Zc	Pride Kakumei
k1Ey101ysL0	KNOW KNOW KNOW
Y2p3ROEijNQ	Katteni My Soul
AGne7i4gwZI	I Wanna Be...
FYyX62RMEWQ	Hikari Shoumeiron
WEoZSH_gp20	Glorious Days
_UJW6u9pwsg	Hoshi Ga Matataku Konnayoruni -Game Version
evsLwBbWrvk	Orion
0VpGoDp3FCE	Kimino Shiranai Monogatari
nusYeKN4ByE	Change
MSG4p7rMyn4	Ranbu No Melody
D2CRlGawlOI	â´á´·[í•œê¸€ê°€ì‚¬/í•´ì„] ë„ˆë¥¼ íƒœìš°ê³ (Carrying You/å›ã‚’ã®ã›ã¦) - íˆì‚¬ì´ì‹œ ì¡°, ì´ë…¸ìš°ì— ì•„ì¦ˆë¯¸ (ì²œê³µì˜ ì„± ë¼í“¨íƒ€ OST) [ì¼ë³¸ì–´ ë°œìŒ í¬í•¨]
2OTfIElRkxg	é‹¼ã®ãƒ¬ã‚¸ã‚¹ã‚¿ãƒ³ã‚¹(ê°•ì² ì˜ ë ˆì§€ìŠ¤íƒ•ìŠ¤)
HpLOwMaxc8E	ã¯ãŸã‚‰ãé­”ç‹ã•ã¾ï¼op  ZERO!!ã€€full
_rH-Fb6YM7E	æœˆèŠ±
HygVQOD8R1Y	[ì¼ë³¸ëª…ê³¡] Endless tears - CLIFF EDGE í•œêµ­ìë§‰/ê°€ì‚¬/í•´ì„/ë°œìŒ
7CG2qA_IbAs	ã€HDã€‘ì‚¬ë‘ì€ ë¹„ê°€ ê°  ë’¤ì— ED - Aimer - Ref:rainã€Sub Koreanã€‘
MGFiqGGVAuk	Aldnoah Zero -   BRE@THï¼ï¼LESS feat Mika kobayashi (OST)
wh11u95kimU	No Differences
ou_u8TSThhU	The Distance - Cliff Edge ft. Nakamura Maiko (lyrics)
yEgcUQvFYyk	DOGFIGHT
OzGVz1ClxIc	Snow halation
XCiDuy4mrWU	Initial D - Running in The 90s
ptUYZl0t5mA	â™ª. ë³„ì˜ ëª©ì†Œë¦¬ OST - Through The Years And Far Away [ê°€ì‚¬, Lyrics]
qYvIP2D_XO8	narrative (Remastered)
2B6nj38AdD0	ç´…è“®ã®å¼“çŸ¢
vMti19q-ov0	ì§„ê²©ì˜ê±°ì¸ ED ì•„ë¦„ë‹µê³ ë„ ì”í˜¹í•œ ì„¸ê³„ ìë§‰  ë°œìŒ HD ver
W8UNLOOogU4	è‡ªç”±ã®ç¿¼
XV0R-5GxyyU	Name of Love
mWIaFbHG44s	great escape
8QPyFlJNmus	å¿ƒè‡“ã‚’æ§ã’ã‚ˆï¼
oYQmw6axrdQ	Red Swan
wGBc7Vd6ejM	ì§„ê²©ì˜ ê±°ì¸ 3ê¸° 2ì¿¨ op ã€Šë™ê²½ê³¼ ì‹œì²´ì˜ ê¸¸ã€‹ í’€ë²„ì „ (ìë§‰)
h8MB492MXgE	Raise your flag
f48dPf3jWsE	Survivor
m5tYVyfb_8Q	STEEL -é‰„è¡€ã®çµ†-
PEVBOsSZkN8	Rage of Dust
ZxCSn2osKQQ	Fighter
e1EExQiRhC0	Freesia
v6vBNzYOXwU	Endless Rain
HWLIIetcILY	Super Driver
GHUa9jrvgSM	ã€Lyrics AMVã€ Black Bullet OP Full ã€ŒBlack bullet - fripSideã€  Francisco Lyrics
-VKIqrvVOpo	ìš”ë£¨ì‹œì¹´ - ê·¸ì € ë„¤ê²Œ ë§‘ì•„ë¼ (MUSIC VIDEO)
F64yFFnZfkI	ìš”ë£¨ì‹œì¹´ - ë§í•´ì¤˜.(Music Video)
3MCp8OUMqgE	ì• ë‹ˆìŒì•… ì€í˜¼ 3ê¸° ì—”ë”© ëˆˆì˜ ë‚ ê°œ(Yuki no Tsubasa)
MF8kHWWFO10	seven oops - Lovers
KId6eunoiWk	LiSA - Crossing Field
CpDyF4pkbAs	Luna Haruna - Overfly
CSnCY_jkff0	[ê°€ì‚¬,ìë§‰] 'ê°€ë”ì€ ì‹ ë‚˜ëŠ” ë…¸ë˜ë„ ë“¤ì–´ë´ìš”' 2ë¶„ì˜ 1 - BACK-ON ( ãƒ‹ãƒ–ãƒ³ãƒã‚¤ãƒ - BACK-ON )
l3xERyhSppQ	ë‹ˆì„¸ì½”ì´ 1ê¸° 1ì¿¨ OP Click (mp3 original)
m5BW7NGhw1k	ClariS - Step (Nisekoi Theme 2) (Audio)
VgeROmbA-nk	ë‹ˆì„¸ì½”ì´ 2ê¸°op Rally Go Round ãƒ‹ã‚»ã‚³ã‚¤2 op Rally Go Round
477jdFG4cOU	(í•œê¸€ìë§‰) ìš¸ê³  ì‹¶ì€ ë‚˜ëŠ” ê³ ì–‘ì´ ê°€ë©´ì„ ì“´ë‹¤ ED - ê±°ì§“ë§ìŸì´ / ìš”ë£¨ì‹œì¹´
8NqLb6xMJkw	irony(ë‚´ì—¬ê·€ 1ê¸° OP) í•œê¸€ìë§‰ í’€ë²„ì „
Wz-pNcgYo0c	Don't say lazy [ending 1 K-on]ã€FULL versionã€‘~ Lyrics English - Romaji - æ—¥æœ¬äºº - í•œêµ­ì–´ - ä¸­æ–‡ / Sub EspaÃ±ol
Z6BF_5p4jMY	Kill la Kill Opening 2 Full ~ â€¢ Ambiguous â€¢ ~
5Anbuz1rFFU	ì¹¸ì½”ë ˆ ì• ë‹ˆ ED í›„ë¶€í‚¤(å¹é›ª)fullë²„ì ¼ í•œê¸€ìë§‰
2A0Rqo7DB7U	í•¨ëŒ€ ì½œë ‰ì…˜ - ë°”ë‹¤ìƒ‰ [ìë§‰]
dv13gl0a-FA	Initial D - Deja Vu
dNGiRuLABgI	aLIEz
8S74b6DW0fg	Niko / Night Of Fire ê°€ì‚¬&ë²ˆì—­ã€Lyrics/Initial D/Eurobeat/ì´ë‹ˆì…œD/ìœ ë¡œë¹„íŠ¸ã€‘
CrJSn4a2hYg	Annalise / Promised Land ê°€ì‚¬&ë²ˆì—­ã€Lyrics/Initial D/Eurobeat/ì´ë‹ˆì…œD/ìœ ë¡œë¹„íŠ¸ã€‘
KDXsZbsrHWo	Bubble (feat. Uta)
3Eo02oa0GtU	(í•œê¸€ìë§‰) ì—¬ì¹œ, ë¹Œë¦¬ê² ìŠµë‹ˆë‹¤ OP Full - ì„¼í‹°ë¯¸í„° / the peggies
Pb6MyDbODqM	ãƒãƒŠãƒã‚¤ãƒ­
XdczBzp9rDc	Hazy
8Lz3IwqrRV8	Kanata no Astra - Full Openingã€ Star* Frostã€by Nonoc
rk2HTJzs73E	Riko Azuna - Glow at the Velocity of Light
KTZ-y85Erus	ìš”ë£¨ì‹œì¹´ - ê·¸ë˜ì„œ ë‚˜ëŠ” ìŒì•…ì„ ê·¸ë§Œë‘ì—ˆë‹¤ (MUSIC VIDEO)
TQ8WlA2GXbk	Officialé«­ç”·dism - Pretenderï¼»Official Videoï¼½
XSsIE5RvDEY	é¢å½±ãƒ¯ãƒ¼ãƒ—
bJiY39dfX4A	å½±è¸ã¿
q4VpnwdkPKI	å¤¢è·¯
2DmXi4aW4V8	Hanasaku Iroha ED 2 Full || Hanasaku Iroha - Clammbon
QcH0QS7A3fM	X-Japan Tears (ê°€ì‚¬ í•œê¸€ ìë§‰)
4oX8Ih9r4oI	Bokurano OP [Uninstall - Chiaki Ishikawa - ]
bt8wNQJaKAk	Officialé«­ç”·dism - I LOVE...ï¼»Official Videoï¼½
A8YZelgycBY	(í•œê¸€ ê°€ì‚¬,ìë§‰,ë°œìŒ)ë¶ˆê½ƒì†Œë°©ëŒ€ OP inferno - Mrs. GREEN APPLE - ã‚¤ãƒ³ãƒ•ã‚§ãƒ«ãƒ
6YZlFdTIdzM	ONE OK ROCK - Clock Strikes [Official Music Video]
9aJVr5tTTWk	ç±³æ´¥ç„å¸« - ãƒ”ãƒ¼ã‚¹ã‚µã‚¤ãƒ³ , Kenshi Yonezu - Peace Sign
Fkeq0ZjBqJs	êµ¬ë¦„ê°™ì€ ë‹¤ì •í•¨ìœ¼ë¡œ ì•ˆì•„ì¤„ê²ŒğŸŒ¼: ì•„ì´ë¬­ - ë§ˆë¦¬ê³¨ë“œ(marigold) [ê°€ì‚¬/ë°œìŒ/í•´ì„]
ynqPnb3BFbU	RPG - Sekai no Owari ê°€ì‚¬/ë…ìŒ/ë²ˆì—­
hYgdEuvhPqM	[ì•„ì´ëŒë§ˆìŠ¤í„° ë¹›ì˜ ì €í¸ìœ¼ë¡œ] m@sterpiece ë§ˆìŠ¤í„°í”¼ìŠ¤ [HD/60í”„ë ˆì„/1080P/ìë§‰]
bbSdE2lzGgs	Little Bird
Ua3nIzKiikg	ã€Œloserã€-  ìš”ë„¤ì¦ˆì¼„ì‹œ(ç±³æ´¥ç„å¸«) (ì¼ë³¸ì–´ ìë§‰ / í•œêµ­ì–´ ìë§‰/ ì¼ë³¸ì–´ ë°œìŒ)
RA1JSWTOMC0	Vermillion
ZGM90Bo3zH0	Steins;Gate Opening Theme - Hacking to the Gate (Full Version)
8ZuE9Twti8I	Tsunagu kizuna yosuga no sora ending sub esp
5QNaSMiZ_-o	God knows...
kLWEViLhnM4	ã€HDã€‘å‡ªã®ã‚ã™ã‹ã‚‰ OP2 -  ebb and flowã€ä¸­+æ—¥+ç¾…é¦¬å­—å¹•ã€‘
ixQp5kvW_Tw	Ending: Nagi no Asukara (1) Lyrics
_9BovisFIm4	ã€Œä¸‰ã¤è‘‰ã®çµã³ã‚ã€~Mitsuba no Musubime~ (Nagi no Asukara ED2) ã€Yanagi Nagiã€
FKwXsK-BO2Y	SawanoHiroyuki[nZk] - Avid(í•œê¸€ìë§‰)
h7digACgKDY	Driver's high gto Opening
xZdVDoUWxDA	ìœ¤í•˜, í˜œì„±[Younha, ã»ã†ãæ˜Ÿ] ì¼ë³¸ì–´/ë°œìŒ/í•œêµ­ì–´
yPda5TYLE3o	Heavenly Blue
1dIFMIhkNQc	Prover
Ba0fGAYDQLE	æ˜ŸãŒé™ã‚‹ãƒ¦ãƒ¡
puoP1AMNlNY	ã€ê°€ì‚¬/í•´ì„ã€‘ RADWIMPS - ìµœëŒ€ê³µì•½ìˆ˜(æœ€å¤§å…¬ç´„æ•°)
3KGjAw0fGX0	UNISON SQUARE GARDENã€ŒPhantom Jokeã€MV
ri2VCCTg7SM	ã€ HD ã€‘Tell me (Fate / Grand Order ì ˆëŒ€ë§ˆìˆ˜ ì „ì„  ë°”ë¹Œë¡œë‹ˆì•„ ED3 ) - milet - ã€éŸ“æ—¥å­—å¹• / í•œì¼ìë§‰ã€‘
bSRq2IxGpyw	ã€Prayã€Nana Mizuki æ­Œã£ã¦ã¿ãŸ
emGzixIiJ6k	Kasanova - Love shining
Zer6dhT-z7M	[í•œê¸€ê°€ì‚¬] Grand Blue(ê·¸ë‘ë¸”ë£¨ ì˜¤í”„ë‹) - ì‡¼ë‚œë…¸ì¹´ì œ(æ¹˜å—ä¹ƒé¢¨) ìë§‰/ë²ˆì—­
zG0JxmQmg3w	Yakudo
CXDUXjsU5ao	Staple Stable
XfjOSXQm5Eo	Irony
Yqz_G25CjrE	Step
Rbgw_rduQpM	I Really Want to Stay at Your House
T_iLqam_f4E	Mirai
dmib40Usy20	Seimeisen
b_bjtIeqIR4	ãƒ¯ã‚¿ãƒªãƒ‰ãƒª
smf8005pRMo	Rage your dream
Po2Ujyn8SXE	Harunohi
HHWdW42aJtE	ì§€ê¸ˆì—ì„œì•¼ ë„¤ê°€ ìƒê°ë‚˜ğŸŒ§: ì•„íƒ€ë¼ìš” - ì—¬ë¦„ ì•ˆê°œ(å¤éœ) [ê°€ì‚¬/ë°œìŒ/í•œê¸€ ìë§‰/í•´ì„]
WmZQFfypvhg	My Dearest
-p0IjnBhG10	The Everlasting Guilty Crown
3LjKx9Ikp8w	Rayã€Œebb and flowã€Official Music Video/Full Sizeï¼ˆTVã‚¢ãƒ‹ãƒ¡ã€Œå‡ªã®ã‚ã™ã‹ã‚‰ã€æ–°OPãƒ†ãƒ¼ãƒï¼‰
C9vAUfSEh8Q	BUMP OF CHICKENã€ŒSOUVENIRã€
E9Dru15yq9w	yamaã€è‰²å½©ã€MVï¼ˆTVã‚¢ãƒ‹ãƒ¡ã€ŒSPYxFAMILYã€ç¬¬2ã‚¯ãƒ¼ãƒ«ã‚¨ãƒ³ãƒ‡ã‚£ãƒ³ã‚°ä¸»é¡Œæ­Œï¼‰
ihhdNqG32cw	[ì§í‚¤í”½ğŸ”¥ğŸ”¥] ë„ˆëŠ” ë¡ì„ ë“£ì§€ ì•Šì•„: ã‚ã„ã¿ã‚‡ã‚“(Aimyon) - å›ã¯ãƒ­ãƒƒã‚¯ã‚’è´ã‹ãªã„ (Kimi Wa Rock Wo Kikanai) (2017) [ê°€ì‚¬í•´ì„/ë²ˆì—­]
sVEc3XmaLvc	[í•œê¸€ìë§‰] íŒŒí‹°í”¼í”Œ ê³µëª… OP Full - ì¹˜í‚¤ì¹˜í‚¤ ë°¤ë°¤(ãƒã‚­ãƒã‚­ãƒãƒ³ãƒãƒ³, Chitty Chitty Bang Bang) â”‚ QUEENDOM
NlH2pvi2udo	[í•œê¸€ìë§‰] ë¦¬ì½”ë¦¬ìŠ¤ ë¦¬ì½”ì¼ ED Full - ê½ƒì˜ íƒ‘(èŠ±ã®å¡”) ) â”‚ ì‚¬ìœ ë¦¬(ã•ãƒ¦ã‚Š)
bqpEAIVqT6M	SHUFFLE! OP ã€ŒYOUã€
OpJ5Y1CUYCw	[í•œê¸€ìë§‰] ë²Œê±°ë²—ì€ ìš©ì‚¬(è£¸ã®å‹‡è€…) - Vaundy
jKTC6TpvZfQ	íƒì •ì€ ì´ë¯¸ ì£½ì—ˆë‹¤ OP : ë©”ì•„ë¦¬, jon-YAKITORY / ì—¬ê¸°ì— ì‚´ì•„ìˆì–´ / í•œêµ­ì–´ ìë§‰
UycYDDRF2qA	íˆì¹´ë£¨ì˜ ë°”ë‘‘ ED - Get Over(ì¼ì–´íŒ, ìë§‰)
wXiCbXD42AI	[í•œê¸€ìë§‰] ì•¼ë§ˆë‹¤ì™€ 7ëª…ì˜ ë§ˆë…€ OP ãã¡ã¥ã‘Diamond | ì…ë§ì¶¤ ë‹¤ì´ì•„ëª¬ë“œ
V6bH5H3ZPII	Butterfly Kiss Rave Master OP
sTi-9tFG-6g	Driver's High
pJ-1-jokFZ4	[í•œê¸€ìë§‰] ë¬¸í˜¸ ìŠ¤íŠ¸ë ˆì´ë…ìŠ¤ 1ê¸° 1ì¿¨ ED åå‰ã‚’å‘¼ã¶ã‚ˆ | ì´ë¦„ì„ ë¶€ë¥¼ê²Œ
ptnYBctoexk	ç±³æ´¥ç„å¸«  - é¦¬ã¨é¹¿   Kenshi Yonezu - Uma to Shika
_ym-MQ5PINA	[í•œê¸€ìë§‰] ë“€ë¼ë¼ë¼ 1ê¸° 2ì¿¨ OP ã‚³ãƒ³ãƒ—ãƒªã‚±ã‚¤ã‚·ãƒ§ãƒ³ | Complication
4rtzeD6cuuk	[ê°€ì‚¬,ìë§‰] 'ë¸”ë™ì­ OP' ì›”ê´‘í™” - ì” ë‹¤ë¥´í¬ / æœˆå…‰èŠ± - Janne Da Arc
SVkGRoLicuA	å¥½ãã ã‹ã‚‰ã€‚
y07N6neDYQ8	[ìƒ¤ë¥¼ë¡œíŠ¸] ED - ë¶ˆíƒ€ ë–¨ì–´ì§€ì§€ ì•ŠëŠ” ë‚ ê°œ Full ver.
iYBk5eevAeQ	Ushinawareta mirai wo motomete opening lyrics
PtA879q09P4	é–ƒå…‰
5g-glh0eTYY	765PRO ALLSTARS - READY!! [Official Audio]
hrfnpTGUfmg	ğŸ’«ê°€ìŠ´ ë²…ì°¨ì˜¤ë¥´ëŠ” ë…¸ë˜ 1ìœ„ : Yuuri - BETELGEUSE (ë² í…”ê¸°ìš°ìŠ¤) [ê°€ì‚¬/í•´ì„/lyrics]
lzyDD8bMDKs	ã€MVã€‘íŒ¬ì„œë¹„ìŠ¤ï¼mona(CVï¼šë‚˜ì¸ ì¹´ì™€ ì‹œì´ë‚˜)ã€HoneyWorksã€‘
gBUp_QKfyLg	Hands Up to the Sky
RuCB-3YavxA	only my railgun
3bR31p1cPqU	sister's noise
cr4k_OUosfE	Get Over
HkQ_mzbC_WY	Complication
udNgJUiBCRg	Blue Bird


321