_HbxPxlIr0Y	a_hisa - Dysthymia
XhevMscHLsI	A Lover's Concerto (Lyrics) - SARAH VAUGHAN
XhevMscHLsI	A Lover's Concerto (Lyrics) - SARAH VAUGHAN
A3yCcXgbKrE	Louis Armstrong - What A Wonderful World (Lyrics)
fJ9rUzIMcZQ	Queen – Bohemian Rhapsody (Official Video Remastered)
3ij_pUtJJrw	ABBA- Dancing Queen (With Lyrics)
IVvkjuEAwgU	Stevie Wonder-Isn't She Lovely Lyrics
-hwiCkU73NA	Santa Esmeralda - Don't Let Me Be Misunderstood / Esmeralda Suite  [HQ & Full Version]
-tJYN-eG1zk	Queen - We Will Rock You (Official Video)
Ev4pwFMaZQc	Queen - We Are The Champions [lyrics]
KKny_ia8Fvo	Queen - Dont Stop Me Now (Lyrics).
I6BqqMuPh2g	Boney M Gotta Go Home
7z9DwMKvqcc	Robert Palmer - Bad Case Of Loving You Lyrics
arg-TuFxmq0	Richard Sanderson - Reality (original, with lyrics)
4x6leDGV7gs	It's Raining Men
MZVY-pGDsN4	Wham - Last Christmas (with lyrics :D)
TcJ-wNmazHQ	Europe - The Final Countdown(with lyrics)
H9nPf7w7pDI	Whitney Houston - I Will Always Love You - Lyrics
EHfx9LXzxpw	Oasis - Whatever (Official Video)
GTwJo0HeNmU	Green Day basket case lyrics
jZO_6PyDJSU	Oasis | Don't look back in anger | Canon in D | Lyrics
8MIBELFORTk	as long as you love me backstreet boys lyrics
v35fWf1CWFQ	Aqua - Barbie Girl Lyrics
wmTaXHB6yyk	Dr Jones by Aqua
pTLnlkrCK8c	Sixpence None The Richer- Kiss Me with lyrics
ltRgb4SJ1uk	Ricky Martin - Livin La Vida Loca | LYRICS
iYJwltQQxQU	Blue- One love with lyrics
_yimOe9ihlU	Hilary Duff - So Yesterday (Lyrics On Screen)
ZrujXrB1_aE	Muse - Time Is Running out - lyrics
5KiuXwYMqOI	Keane-Everybody's Changing
-QN6CB23vL4	Its all about you (lyrics)-mcfly.
RmNTAvnSais	Daniel Powter-Bad Day (lyrics)
4fj9ZoUr1XA	Falling Slowly, Once Lyrics
5NIrNmjQwLk	Lady Gaga - Just Dance(CD RIP)Audio HQ
m3Ztq2hu5Kg	Hugh Grant & Haley Bennett - A Way Back Into Love (lyrics)
pxA26LGI2Mc	Mika -  Happy ending lyrics
bESGLojNYSo	Lady Gaga - Poker Face (Official Music Video)
NLfaLVgSRaY	Jason Mraz - I'm Yours (한국어 자막/해석/가사)
0BsLd4Y060Q	Born This Way- Lady Gaga LYRICS
0oqvSnJamaA	Flo Rida- I Don't Like It, I Love It FEAT. Robin Thicke (Lyrics)
J161D6GuJ8c	7 Years Old - By: Lukas Graham (LYRICS)
n1lfYh-aUk0	Firework - Katy Perry (Lyrics)
QEZq4I2wTBc	JUSTIN TIMBERLAKE CAN'T STOP THE FEELING lyrics
z7dIvtcd6tY	cash cash-party in your bedroom
JqxBeMPAT9w	Backstreet Boys-I Want it That Way Lyrics
Tr97MQiqW38	NOTHING'S GONNA CHANGE MY LOVE FOR YOU (with lyrics) - GEORGE BENSON
IowZqZHJ-cA	The Script - Superheroes (Lyrics)
b1P3pPL-Si8	It Girl   Jason Derulo   Lyrics
O71fetlkCZo	Queen - We Are The Champions Lyrics
ztmBNXXMJ9s	Jason Derulo - Want To Want Me Lyrics
ZTFGMKSW3z4	I Lay My Love On You (Westlife) - Lyrics
bmdFMJWeO-c	Owl City - New York City (Lyrics)
MzCLLHscMOw	The Script - Breakeven (Official Video)
sLqdRmwY6vc	Dynamite-Taio Cruz (lyrics)
OtJB2_rn-qs	The Black Eyed Peas - "Just Can't Get Enough" LYRICS - 2011 Single HD
5olfnVeYfgg	Bruno Mars - Grenade [Lyrics]
T3553DGF71g	Give Me Everything (Tonight) - Pitbull ft. Neyo, Nayer & Afrojack w/ lyrics on screen & download HD
_6KW4C4Rh18	Backstreet Boys - Shape Of My Heart (Lyrics)
XAFS43NKFag	LEMON TREE ANIMATION with LYRICS! - Fools Garden
HeWF_fy8tLE	Alizée - J'en ai marre !
dQw4w9WgXcQ	Rick Astley - Never Gonna Give You Up (Official Music Video)
yPYZpwSpKmA	Rick Astley - Together Forever (Official Video) [Remastered in 4K]
v686vG5PSac	Avril Lavigne - Head Above Water (Lyric Video)
OHW2EC9ZqlM	MIKA ft. Ariana Grande - Popular Song (Lyrics)
zh1s8oTT6uM	Love Drunk
ibqyu7bQ4-w	Jason Derulo - Colors (Lyrics)
3s2ISBhc4YU	Owl City - When Can I See You Again Lyrics
8QKPLYpObd8	Passenger - Let Her Go (가사/해석/한국어 자막)
zOvzecGwBTU	CARLY RAE JEPSEN - YOUR TYPE LYRICS
OE2qEpkWWoQ	Carly Rae Jepsen - Run Away With Me (Audio)
kZGNSAFCbbE	[한글번역] Fall Out Boy - Centuries
zCifUdogjO8	Owl City - Alligator Sky
hSoOqvptTUA	My First Kiss - 3OH!3 ft. Ke$ha Lyrics
wGJ8ixlfKUs	Avril Lavigne-Girlfriend Lyrics
-Kq5ntONZUQ	OWL CITY - Verge (Lyrics)
8leRk0zaBRg	Queen - We Are The Champions (한글 가사 해석)
Sg0CeRog-yQ	Vanessa Carlton ~ A Thousand Miles - With Lyrics
vzFa-OUDmTA	On The Floor - Jennifer Lopez [lyrics]
hyfV0GBe18w	STARSET - Monster (Lyrics HD)
Pw06htMtAZQ	Sigala, Paloma Faith - Lullaby (Lyrics / Lyrics Video)
thhaf-bKWyg	Whatcha' Say - Jason Derulo
gY3l3AAxLZQ	Sum 41 - Over My Head (Better Off Dead) [with lyrics]
1HJ8hYysHPE	Modern Talking - Brother Louie (LYRICS)
Va0vs1fhhNI	Lemon Tree - Fools Garden
r5EXKDlf44M	Green Day -Boulevard of Broken Dreams lyrics
EGikhmjTSZI	Live is Life - Opus
Nntd2fgMUYw	Eagle-Eye Cherry - Save Tonight
rd_ZDjehtrA	Dark Moor - "The Star" (With Lyrics)
jVO8sUrs-Pw	Green Day-Wake Me Up When September Ends lyrics
vZofi2hgiAE	Anne Marie - 2002 (한국어 가사/해석/자막)
Q08427Of6as	a-ha Take on Me Lyrics
LODkVkpaVQA	Tubthumping (I Get Knocked Down) Lyrics
cb9t_MJdK9Q	Butterfly Lyrics by Smile.dk
o1gLGjPFkRA	The Killers - Mr BrightSide Lyrics
a1BS7XnEZqc	Green Day - American Idiot lyrics [1080p]
6kgUNbCMdLo	Aint nothing wrong with that- Robert randolph and the family band
JtxmraqZPH4	Chris Daughtry - Over You [Lyrics]
O3s5RwguEP0	The Script - The Man Who Can't Be Moved (한글 가사 해석)
YEdImVQVQY4	Mika - We Are Golden [ Lyrics ] (HQ)
1agUFG0f50Y	Train - Drive By Lyrics
TYgOlqinH7A	Witch Doctor - Ooh Eeh Ooh Ah Aah Ting Tang Walla Walla Bing
beF4Ywct-Uo	What A Feeling   Irene Cara
cM4qYy-bAg8	Lukas Graham (루카스 그라햄) - 7 years (가사/해석/한국어 자막)
D5drYkLiLI8	Kygo & Selena Gomez - It Ain't Me (Audio)
e2vBLd5Egnk	Martin Garrix & Dua Lipa - Scared To Be Lonely (Official Video)
FM7MFYoylVs	The Chainsmokers & Coldplay - Something Just Like This (Lyric)
9Va88Kt0NN0	Elektronomia & JJD - Free [NCS Release]
fSCnYNAswpk	Axtasia - Light Up The Sky (feat. Soundr) [NCS Release]
peByeoQhjMM	Cash Cash - How To Love ft Sofia Reyes (Official Video)
GeJAee3m3Ik	[MV] HYOLYN, CHANGMO(효린, 창모) _ BLUE MOON (Prod. GroovyRoom)
aatr_2MstrI	Clean Bandit - Symphony (feat. Zara Larsson) [Official Video]
Ir4ZqsfGE78	Don Diablo & Marnik - Children Of A Miracle (Official Music Video)
ubtbkgUmHHE	Kygo, Ellie Goulding - First Time
oTvVxD1clAs	Matthew Koma - Parachute (Kat Krazy Remix)
Ey_hgKCCYU4	Jonas Blue - Perfect Strangers ft. JP Cooper (Official Video)
kbYbvDK-HlY	Mike Perry - Inside the Lines ft. Casso
CFF0mV24WCY	Tiësto - Red Lights (Official Video)
IP8OVYyuC60	Tiësto - Take Me ft. Kyler England (Lyric Video)
bltr_Dsk5EY	Afrojack - Ten Feet Tall (Official Lyric Video) ft. Wrabel
dLhFDYQHDQY	Taio Cruz - Hangover (Official Video) ft. Flo Rida
Cbvqv19Nf0E	Tiësto & Don Diablo - Chemicals (feat. Thomas Troelsen) [Official Music Video]
mLb8gOyRlYo	Revibe, SHAUN - Runaways (ft. Adara)
UtF6Jej8yb4	Avicii - The Nights
prmmCg5bKxA	Sean Kingston, Justin Bieber - Eenie Meenie (Official Video)
L0tfnhacciE	Jim Yosef - Link [NCS Release]
9g6jidr4Zog	Phoebe Ryan - Mine (Illenium Remix)
ZCu2gwLj9ok	Illenium - Fractures (feat. Nevve)
3FRvZe7sY0U	The Chainsmokers, Tritonal - Until You Were Gone (Audio) ft. Emily Warren
qPTfXwPf_HM	Jonas Blue - Mama ft. William Singe (Official Video)
g4hGRvs6HHU	Alan Walker ft. Gavin James - Tired
eSSO1LfMO8w	Tritonal feat. Phoebe Ryan - Now Or Never (Official Lyric Video)
JkOXrWGjz_M	Tritonal - Anchor (OFFICIAL VIDEO)
PGzeBL-tMOI	Me Singing - One Last Time by Ariana Grande - J.Fla cover
3B09jd-wMaE	Chelsea Cutler - Sixteen (Lyrics / Lyric Video)
d4M4aDJPYD8	Remady & Manu-L - L.I.F.E.
4tBnF46ybZk	WINNER - 'REALLY REALLY' M/V
Fw_iIGO8_tY	Syzz & Jim Yosef - Promises (feat. Michael Zhonga)
Cg4J0FT3fAs	Cash Cash - Aftershock ft Jacquie Lee (Official Video)
kJQP7kiw5Fk	Luis Fonsi - Despacito ft. Daddy Yankee
lEi_XBg2Fpk	The Chainsmokers - All We Know (Audio) ft. Phoebe Ryan
dknxch_XzM4	Feenixpawl & APEK - Quicksand
sJ6hAQjW9Aw	OneRepublic, Seeb - Rich Love (Audio)
z6nfK_zhYNk	The Chainsmokers - Young (Lyric)
MReNmBOspAg	Jim Yosef & Anna Yvette - Courage [NCS Release]
D0_GWTy9FEM	Ellie Goulding - Something In The Way You Move (Directed by Emil Nava)
rabOaM2kh9c	Ryos ft. Karra - Where We Are [Premiere]
-AfjBifqK_E	Gryffin & Illenium ft. Daya - Feel Good [Official Lyric Video]
fwUqWgHMlyo	Alan Walker & Alex Skrindo - Sky
tdU2Q6uIs0M	Remady, Manu-L - Give Me Love
87gWaABqGYs	Ed Sheeran - Galway Girl [Official Music Video]
QqccaHauSKQ	Vicetone - Nevada (feat. Cozi Zuehlsdorff) [Monstercat Official Music Video]
X46t8ZFqUB4	Zedd - I Want You To Know ft. Selena Gomez (Official Music Video)
m_SSr-tbY_M	Italobrothers - Summer Air (Official Video) [Ultra Music]
fzNMd3Tu1Zw	Elektronomia - Energy [NCS Release]
ovvfqeouFQI	Tobu - Melomania
WhQLqmef15c	Polyphonix - I believe feat. Kanae Asaba, mana ( Polyphonix Countdown Anthem)
nUn331ePDNs	Polyphonix - Blossom (B - Blossom)
vlrRLW1-ju4	Carolina Marquez feat. Flo Rida & Dale Saunders - Sing La La La (E-Partment Mix) (Official Video HD)
P6OQ6EQxMuA	R.I.O. Feat. U-Jean - Summer Jam (Official Video HD)
vusqQJ56iIM	Kygo - Carry Me ft. Julia Michaels (Official Video)
d_11fwrn6Ow	R.I.O. - Headlong (Official Video HD)
Rh9pjsM1nUI	Diviners - Savannah (Avicii & Kygo Style)
3nQNiWdeH2Q	Janji - Heroes Tonight (feat. Johnning) [NCS Release]
9auvIgOTgUI	Mike Candys feat. Maury - Miracles (Official Video HD)
8sPj0Ic8KQ8	R.I.O. feat. Nicco - Party Shaker (Official Video HD)
s4tqBvt5i3k	Mike Candys & Evelyn feat. Patrick Miller - One Night In Ibiza (Official Video HD)
MqUCDzom5Xw	Jim Yosef - Can't Wait (feat. Anna Yvette) [NCS Release]
cyvyHcLHSfY	Mike Candys feat. Evelyn & Carlprit - Brand New Day (Official Video HD)
FGSFgaNZ2AQ	Michael Mind Project - Antiheroes (Official Video HD)
LK22M3puRT8	Remady feat. Manu-L - The Way We Are (Official Video HD)
VTqmldgLzdk	Manian feat. Carlprit - Don't Stop The Dancing (Official Video HD)
lP6mK2-nLIk	Jim Yosef - Speed [NCS Release]
thpsmZiDv6U	Alesso - Sweet Escape ft. Sirena
diKTMKltATk	Avicii - Friend Of Mine (Part 1 - Lyric Video) ft. Vargas & Lagola
i_ym39YgtCo	Avicii - Lonely Together (Part 2 - Lyric Video) ft. Rita Ora
u3VFzuUiTGw	Mike Posner - I Took A Pill In Ibiza (SeeB Remix)
RhU9MZ98jxo	The Chainsmokers - Paris (Official Lyric Video)
_qj2WaB2ga0	Avicii - Without You ft. Sandro Cavazza [Lyric Video]
a2YztBB4Mnc	Rootkit - Against the Sun (feat. Anna Yvette)
8h-fqAnIn0A	Ampyx - Rise
h--P8HzYZ74	Zedd, Alessia Cara - Stay (Lyric Video)
5JxgDJvqGmM	Mike Perry - The Ocean ft. Shy Martin
fRh_vgS2dFE	Justin Bieber - Sorry (PURPOSE : The Movement)
n1a7o44WxNo	Zedd - Beautiful Now ft. Jon Bellion (Official Music Video)
sYcUv68nFUw	ItaloBrothers - This Is Nightlife (Official Video HD)
A9lImW4wUiU	Janji - Together (Feat. Vivien) [NCS Release]
vRq-WUPnNYw	Remady & Manu-L - Higher Ground [Official Video HD]
FYAHVmzzNkk	Jim Yosef - Journey
3uairflAcvE	Jim Yosef - Rogue [Ninety9Lives]
acCSekUAbZM	Starlyte & Jim Yosef - Leviathan [Free Download]
x_OwcYTNbHs	Jim Yosef - Firefly [NCS Release]
WJ7cI7heqac	Mike Perry - Stay Young (ft. Tessa)
rLJqG7HzqjQ	Grey - Crime (Lyrics / Lyric Video) feat. SKOTT
hT_nvWreIhg	OneRepublic - Counting Stars (Official Music Video)
j5bPx6gPogE	ALIUS - Nobody Can Hear You (Lyrics / Lyric Video) feat. Ariela Jacobs
XPygdpmTGDo	Illenium - Beautiful Creatures (ft. MAX)
u2AoPOd_bhw	3LAU - Star Crossed
Od8yBWoOU1I	ThimLife ft. Vanessa - Friends
WdrPoOrKrBo	Thimlife & Marque Aurel ft. Vanessa - Believe
TW9d8vYrVFQ	Elektronomia - Sky High [NCS Release]
tt2k8PGm-TI	ZAYN - Dusk Till Dawn (Official Video) ft. Sia
L4p-g3AprzU	Gryffin - Nobody Compares To You (Lyrics / Lyric Video) ft. Katie Pearlman
JtLzeeFzcFo	Jim Yosef - Flash
rd183kwmVV4	Jim Yosef - Unicorn [Ninety9Lives]
DFfIotUaalo	Mokita & Maty Noyes - Goodbye (Lyrics / Lyric Video)
hEdvvTF5js4	Kygo, Justin Jesso - Stargazing ft. Justin Jesso (Official Video)
DfLqy83UHk8	Illenium - Free Fall (Lyrics / Lyric Video) ft. RUNN
-HfVh4chdmE	Illenium - Let You Go (Lyrics / Lyric Video) ft. Ember Island
6WrFYMNltCg	Jim Yosef - Dimensions
pGeX-yNOJTA	Jim Yosef - Whisper
VDH5SrgSU1E	Lost Kings - First Love (Lyrics / Lyric Video) Ft. Sabrina Carpenter
5AtkWnBjGBU	HandClap
wJnBTPUQS5A	Alan Walker - The Spectre
CbOeURhMAIc	Sing Me to Sleep
5AtkWnBjGBU	HandClap
gcaL-N0AiDw	WALK THE MOON - One Foot (Lyrics / Lyrics Video)
6JCLY0Rlx6Q	WALK THE MOON - Shut Up and Dance (Official Video)
nptQHKQ4p2E	Wild Cards - Falling Down (Lyrics / Lyric Video) ft. James Delaney
_tNYLM5IDuo	Justin Caruso - Caving (Lyrics / Lyric Video) ft. James Droll
hdP6LPGhv-k	Koni & Maria Lynn - Dive In
r5EUGbtxl1Q	Emily Vaughn - Over That (Lyrics / Lyric Video) feat. Yippycult
IOZH6oioJQ0	BTS (방탄소년단) - 피 땀 눈물 (Blood Sweat & Tears) [Lyrics Han|Rom|Eng]
XJNxRVeGO6Q	Steve Void - Perfect Mess (Lyrics / Lyric Video) ft. Laurell, With Navarra
2wk7ssph8XA	Tobu & Wholm - Motion
SxLYJ2trV-Q	f(x) (에프엑스) All Mine Lyrics (Han|Rom|Eng) Color Coded
83_UnqjGRJs	Tobu, Wholm & Blume - Cool
qXiuVQ-GgA4	OneRepublic - No Vacancy (Lyric Video)
R19uQyfwqhg	MitiS - Moments (feat. Adara)
TGx0rApSk6w	OneRepublic - If I Lose Myself (Official Music Video)
V6iKSUoUN48	Avicii - Broken Arrows
zLqs-cUlUb8	Jim Yosef & Anna Yvette - Linked [NCS Release]
jV5sFdpVmN8	브레이브걸스 (Brave Girls) - 롤린 (Rollin’)
7ABNEjPxWEg	Scouting For Girls - She's So Lovely
MBdVXkSdhwU	BTS (방탄소년단) 'DNA' Official MV
NyVYXRD1Ans	The Greatest Showman Cast - The Greatest Show (Official Audio)
c2FB1_ohlek	B.o.B ft. Hayley Williams - Airplanes (Feint Remix) HD
VTDw-VWYpVg	[MV] Orange Caramel - 샹하이 로맨스
AQ0resnXCcE	Hardwell feat. Chris Jones - Young Again (Official Video HD)
xpEl02UnA3c	Tobu - Calling
y_SI2EDM6Lo	Taio Cruz - Break Your Heart (Official Video) ft. Ludacris
sJDrVaT8Dys	Tobu - Something Right (ft. Game4)
F4qfN5UeFvQ	[MV] SUNMI (선미) _ Heroine (주인공)
QuR-s8IkhzU	Tobu - Happy Ending (Lyric video) ft. Cassandra Kay
IgGjUjQRAxw	Zedd - Find You ft. Matthew Koma, Miriam Bryant (Official Music Video)
3WrFSRgl8VY	R.I.O. Feat. U-Jean - Ready Or Not (Official Video HD)
kvum8Yb94sw	R.I.O. feat.  U-Jean - Turn This Club Around (Official Video HD)
g0qX62Patoo	MitiS - Open Window (feat. Anna Yvette)
eCOjLpM2fqE	[STATION] Juncoco X Advanced 'Atmosphere (Feat. 에일리)' MV
ZF_xhzuAzXw	Mulshine & River - Burning It Down
zYoYoBtLqOY	KARA - STEP M/V
WfwnietuaME	윤하 - 혜성 (Mp3.)
i9JYEJA3E6U	Mighty Mouth - 나쁜놈 (feat. 소야)
zytefWJVHn0	Anna Graceman - Words (Glastrophobie Remix)
qsv2B1ztlgw	3LAU - Touch (feat. Carly Paige)
GFewCh-ZYt8	브라운아이드 걸스 (Brown Eyed Girls)- 어쩌다 Uh Jjuh Da/Eo Jjeo Da (What Happened/How)
goRGKll_zE0	Tobu - Sound of Goodbye
YGLA_V_yZXo	Culture Code - Feel Again (feat. Harley Bird) [NCS Release]
o5UetNjCDVQ	Tritonal - Out My Mind feat. Riley Clemmons [OFFICIAL AUDIO]
-kZV3Quu9rI	[한글번역] Lauren Aquilina - Ugly Truth
d0p0iNa7ktQ	03 How Dare You  니까짓게   SISTAR 씨스타
ADAR8PDIwuw	Jim Yosef & Chris Linton - Breathe
hjJAF5o2wEo	Andreas B. - I Need Your Love (Full Version)
QOowQeKyNkQ	Chris Brown - Don't Wake Me Up (Official Music Video)
Zr8px68XnkE	Rainbow(레인보우) - Tell Me Tell Me
6sTBSl3M2FE	Ke$ha-TiK ToK Lyrics
X90M32q-ifw	After School (애프터스쿨) - Shampoo (샴푸)
cF7af1e6Suk	Avicii - Come to me  (lyrics) New song 2016
fUmFWTjGT7Q	01. HELLOVENUS (헬로비너스) - Do You Want Some Tea? (차 마실래?) - [3rd Mini Album]
AmdgIK8-raM	티아라(Tara)   TTL (Time To Love) (가사 첨부)
5V62f50AiKs	김아중 - 마리아 (Kim Ah Joong - Maria) Lyrics
bNKTLeUlh4A	풋사과 (Feat. 정일훈 of BTOB)
NCvt-5RI4pE	KARA - Wanna [Han & Eng]
U2_oNb_d0qU	Escape The Fate - Broken Heart (Official Lyric Video)
5naoFO3LUks	From now on - Hugh Jackman 위대한 쇼맨 OST [가사/해석/한국어자막]
1sSRLikPmgY	01. T-ara (티아라) - Day by Day (Audio)
cllEoGTbPIM	After School (애프터 스쿨) - Because Of You (너 때문에) ~Audio~
4LYLsJaUWGo	Ke$ha - Die Young lyrics
aCTkrnpGroA	Remady, Manu-L - Back Again ft. Lyracis
iurFTXxWLbY	DBSK - 풍선 (Balloons) [Han & Eng]
Xsp5vgo9FxU	[Full Audio] IU - AION Soundtrack (Atreia) / 아이유 아이온 OST (아트레이아)
O3mFmCg-NUI	씨스타(Sistar)  가식걸 (가사 첨부)
_V2kaTq0wUg	f(x)  (에프엑스) Cash Me Out Lyrics Color Coded [Eng & Rom]
LU-ZQWZSGfc	Jason Derulo - In My Head (Official Lyrics Video)
Vgm-adAsiIU	휘성-Insomnia (불면증)
Pt2U_4PU8ec	[APINK] Mr. Chu (Hangul/Romanized/English Sub) Lyrics
WTKD7X0mFq8	I really like you- Carly Rae Jepsen (LYRICS)
ggp2q5TSNDg	럼블피쉬 - 으라차차.wmv
04Xy83aiMgw	SNSD 소녀시대 - 힘내! ( Way To Go ) CD quality audio with lyrics
SN-1ElJzihI	A PINK - LUV Lyrics (Rom+Han+Eng)
dbQ5FSnExYg	APink No No No[Han+Rom+Eng Lyrics]
D32eLVvn7tw	Axel Johansson - Next To Me (Lyrics Video)
2qj3g0c-fSI	테일즈위버 EP3 공명 OST - 02. U+Me - f(x)루나
ntTRbTkw4UA	BoA (보아) - Atlantis Princess (아틀란티스 소녀) [Han/Rom/Eng Lyrics]
8pUQF-hubCA	[The Greatest Showman] Zac Efron & Zendaya - Rewrite the stars (한국어 가사/해석/자막)
YvtPozPUeZ0	State of Sound - Wake Up Where You Are (Lyric)
O1CYi_N9AfE	Love me again - John Newman w/lyrics
_PQOELbHTIA	DubVision & Afrojack - New Memories (Official Music Video)
pxA26LGI2Mc	Mika -  Happy ending lyrics
7uRD2UIaYyM	The Other Side - Hugh Jackman 위대한 쇼맨 OST [가사/해석/한국어자막]
1DgL2qqzsIc	[MP3 DL] Mighty Mouth - 랄랄라 (Feat Soya)
whlVRDTobhs	B2ST/BEAST (비스트) – FICTION Color Coded Lyrics [Rom/Eng/Han] 1080p
zW6UOOvQulQ	A Pink - Hush
v6Yjlplp_3U	f(x) (에프엑스) - Hot Summer (Han | Rom | Eng Color Coded Lyrics)
cYXyzXBhecI	AOA - Heart Attack  (심쿵해) (Color Coded Han|Rom|Eng Lyrics)
70MBQrlsr_M	f(x) - Airplane [Hangul/Romanization/English] Color & Picture Coded HD
YPwgTPA09ug	오렌지캬라멜(Orange Caramel)   방콕시티 (Bangkok City) (가사 첨부)
kRt9khbm4OE	Apink - My My Lyrics (Romanization/Hangul/English) Color Coded
GOjx552BCPE	Apink (에이핑크): Bubibu Lyrics
WZkviMHXoTI	MC몽 Indian Boy(인디안 보이)  (feat  장근이, B I) (가사 첨부)
OQw9u2dqm5k	F(X) - …IS IT OK? (좋아해도 되나요) [Color Coded Han|Rom|Eng]
bw58ZpMCRLI	Girls' Generation / SNSD (소녀시대) - Snowy Wish (첫눈에...) lyrics (HAN ROM ENG)
4YmlVhQmpg4	[MP3/DL] Dal Shabet - Have, Dont Have 있기 없기
YgrA_9wD590	LABOUM (라붐) - Hwi Hwi (휘휘) Lyrics (Han|Rom|Eng|COLOR CODED)
_HbxPxlIr0Y	a_hisa - Dysthymia
3aOzItICytI	Valentin - "A Little Story"
OBB55oPaFyU	정군 - Blue star
S1AWZNmEL4s	【Jazz Hip-Hop】' Valentin - A Little Story '「image by Bob」
KOcf6p8YC08	[순수 모바일 작곡] 밤 빛의 언덕 / Light of Night and Hill (Neal K) - FL Studio Mobile
mxorHPrUyvs	Piano Master - Eastern Island
6t8jXC_Hktk	Raujika - Grim
u3VFzuUiTGw	Mike Posner - I Took A Pill In Ibiza (SeeB Remix)
N1kpeRhqVzI	Beth - Don't You Worry Child (Charming Horses Remix) (Official Video HD)
6MReeYAcEUM	ItaloBrothers - Sleep When We're Dead (Official Video)
NQR4Pa2VqMU	Arc North - Meant To Be (Kygo Style)
Ohdx3Sa4eyk	Jim Yosef - In Time
hWdovALEen0	KSHMR & Crossnaders ft. Micky Blue - Back To Me (Official Lyric Video)
FZ_paWpT9Mo	Mahmut Orhan - Save Me feat. Eneli (Official Video) [Ultra Music]
gUo3l9RZt4s	Hardwell feat. Haris - What We Need (Best Audio) [Free download]
OzYW_VzGleQ	DJ Antoine - La Vie En Rose (Official Lyric Video HD)
SeIJmciN8mo	Nicki Minaj - Starships (Explicit)
uODX-okCMX0	Cheat Codes - Sober (Lyrics / Lyric Video) With Nicky Romero
S_5IMBT5Elw	Illenium - Lost (ft. Emilie Brandt)
iKzRIweSBLA	Ed Sheeran - Perfect [Official Lyric Video]
fPHKuk8O3a8	Tiësto ft. Stargate & Aloe Blacc - Carry You Home
5dJG_DdOuOM	Illenium - Lost (Lyrics / Lyric Video) ft. Emilie Brandt
Y79oUZ4AeKg	ItaloBrothers - Sorry
WNhWOTxDxDI	Two Friends - Emily (Lyrics / Lyric Video) Zack Martino & BEAUZ Remix, Feat. James Delaney
QKEKYm3mIFA	ZAYN - Dusk Till Dawn ft. Sia ( cover by J.Fla )
FgbW2JH-k_E	Illenium - Let You Go (ft. Ember Island) | Chill
AYYr4DrN72A	테일즈위버 EP3 공명 OST - 03. GRAVitation - 시크릿
8gz9NsNH96Q	Galantis & Hook N Sling - Love On Me (Official Video)
WxZNWp2LUMw	Jim Yosef - Sunrise (feat. Reece Lemonius) [Ninety9Lives]
nbXgHAzUWB0	Axwell Λ Ingrosso - Sun Is Shining (Official Music Video)
YxbT8DcXBko	Tritonal feat. Laurell - Good Thing
40klkWMoLcU	Starlyte & Jim Yosef - Draconis
IS9azbb9hSA	Elektronomia - Vitality [NCS Release]
XkB35_TkUag	Coldplay - Everglow (한국어 자막/해석/가사)
7bPffIZot10	[MV] YOUNHA (윤하) _ Parade
ysnUHXksic8	NS Yoon-G, (NS윤지) - Reason To Become A Witch(마녀가 된 이유)
TbdZiu3Rarw	RESPECT New Song - Only For You (Full M/V)
MdGlu6vfI9Q	Tritonal - Call Me (Lyrics / Lyric Video) Noah Neiman Remix
t3j-JLylgNk	Vicetone feat. Kat Nestel - Angels [Premiere]
Lj6Y6JCu-l4	Zedd, Maren Morris, Grey - The Middle (Lyric Video)
b0KcfRsGeRM	Mike Candys & Evelyn - Never Walk Alone (Official Lyric Video)
WfwnietuaME	윤하 - 혜성 (Mp3.)
05jT5uWMNqY	현영 누나의꿈 (가사 첨부)
ceZc-5p3g1w	BoA 보아 'No.1' MV
M48JMEkiu3Q	BoA 보아 'Milky Way' MV
DECxluN8OZM	[Dubstep] - Au5 - Snowblind (feat. Tasha Baxter) [Monstercat Release]
VqrHdwBIoOI	엠블랙(MBLAQ) - Stay MV
TzbY0dxTd5M	[PARUN OFFICIAL] Music for Neal k 닐케이님께 바치는 음악 / Skyscape 摩天樓
ivxPepDyqmI	Afrojack & David Guetta - Another Life (Official Music Video) ft. Ester Dean
tnrTN7s-p6Y	Craig David - Insomnia (Official Video)
USHjMEs7_9Q	Stereo love (Radio Edit)
7wnYoLZpzJo	Phoebe Ryan - Dollar Bill (Video) ft. Kid Ink
FLmVORJju40	State of Sound - Wake Up Where You Are
ZwoDYJWWXW0	Alan Walker, Keala Settle & The Greatest Showman Ensemble - This Is Me (Alan Walker Relift)
BVTgnPM-jRQ	R.I.O. - Like I Love You (Official Music Video) [HD]
APe922QQTN0	My Happy Ending
Cwkej79U3ek	Vanessa Carlton - A Thousand Miles
ggiUMDccO0Y	A*Teens - Upside Down
_mkiGMtbrPM	WORLD ORDER  "HAVE A NICE DAY"
xxYvlGZD89A	Jim Yosef - Archer [Fairytale]
nWyhUoxAbYI	The Royal Concept - On Our Way
AibbK096idk	Eric Nam - Honestly ( 솔직히 ) ( cover by J.Fla )
Vd6fuPQ-294	Alizee - J'en Ai Marre (Chanson N°1) HD
oDDf-9xd47U	Remady & Manu-L – Another Day In Paradise
sPCD_Cn82l8	이누야샤 4기 오프닝 Grip! 풀버전
FmkWxzDOu6U	Girl's Day (걸스데이) - Don't Forget Me (나를 잊지마요) (Han | Rom | Eng Color Coded Lyrics)
jk8LmCc7Cmg	Arensky - Feel The Light (ft. Moorea)(Acoustic) | ♫ Copyright Free Music
IkGt3tu23Is	[테일즈위버] 유저 헌정곡 '꿈처럼' (Vocal by 윤하)
dYIT_jeUBKg	[M/V] Free Style(프리스타일) - Y (Please Tell Me Why)
yUR5aIxZCfI	3LAU - How You Love Me feat. Bright Lights [Official Lyric Video]
xD9O7UrjrPg	우린 달려간다
qRXtfk3NYeM	다짐 -- 조성모
c6S5hVUz8yY	Endless Rain - X Japan (Lyrics) แปลไทย
QcH0QS7A3fM	X-Japan Tears (가사 한글 자막)
wRGeQvA4Vvw	Two Is Better Than One
INhrrsOiBTs	Westlife - If I Let You Go (Where Dreams Come True - Live In Dublin)
Imi2E8mVwHQ	에이치오티 (H.O.T.)－「캔디 CANDY」 [LYRICS] 가사 한국어
efuVbrNLuAk	god - 어머님께 MV (뮤비) (1999)
FDYJzsIlV4s	[AUDIO] 컨츄리꼬꼬 - Gimme! Gimme!
tSOSxwEWFA4	SUPER JUNIOR 슈퍼주니어 '미인아 (Bonamana)' MV
wqHX9YmqeyQ	[M/V]SS501 LOVEYA M/V
ziZJeM25tzg	Hero (feat. Mike Mains) - Tommee Profitt
WCbQcSxS7z0	K/DA - 'POP/STARS' LYRICS (ft (G)I-DLE, Madison Beer, Jaira Burns) (Color Coded Eng/Rom/Han/가사)
8IRX1C6vC_I	Avicii - Our Love
FSnAllHtG70	The 1975 - The Sound
iDgoqe-v-io	Vicetone - Way Back (feat. Cozi Zuehlsdorff)
vAEwLvxHVVk	Robin Schulz - Headlights [feat. Ilsey] [Official Video]
XehlywgmwQ0	Dante Klein & Jantine - what i like about u (Official Music Video)
ICQXo55DDMk	사랑을 주세요 - 타이푼 [개구리 중사 케로로 2기 엔딩곡] Full Ver.
qgtDY8CvgcE	A Loss For Words -  Distance
fF08MR7SvkQ	치고달려라 2010 (feat. 천하무적 야구단)
lUapkbzxQmM	Maroon 5 (Feat. Cardi B) - Girls like you (한국어 가사/해석/자막)
o1RFSX5Epmo	소찬휘 Tears
M2hlTs4ngsY	솔리드 천생연분
CDKBuynxXfM	김건모 - 잘못된 만남 (1995年)
kxqn8FAVbpU	앤-마리 (Anne-Marie) - 2002 (Live) 가사번역 by 영화번역가 황석희
zODtYyHs89A	02 편지 - Outsider
BxaR42Vy2LI	Carry On (from the Original Motion Picture "POKÉMON Detective Pikachu") (Official Video)
v1DqsDhVOqc	버즈 - My Darling (End)
oofSnsGkops	James Blunt - You're Beautiful (Official Music Video) [4K]
efBpYL8FN-I	Bebe Rexha – Meant To Be (feat. Florida Georgia Line) (한글 자막/가사/번역/해석/가사해석/lyrics)
vZofi2hgiAE	Anne Marie - 2002 (한국어 가사/해석/자막)
qDZH30Cqnz4	조성모 진심 (가사 첨부)
K7J_0DDw2RU	01. 죄(罪)와 벌(罰) [가사]
6-y9gHaVQLU	빛
BNDVGuWImw4	OH MY GIRL (오마이걸) – Shower (소나기) Lyrics (Han|Rom|Eng|COLOR CODED)
e3JtpBclG2g	Apink (에이핑크): Remember (리멤버) Lyrics
7l7BUOUSTS4	뜨거운 안녕
36vuOzknlyk	너를 원해
Rt3GVMzAFBE	Trans Fixion-Radio(Original Ver.)
fqzhtvLWefA	Avicii - Heaven (Tribute Video)
QpFXXPruuqU	CHVRCHES - Clearest Blue (lyric video)
PdXZCILKXek	Myo - Horurock
pHXDMe6QV-U	Sunstroke Project & Olia Tira - Run Away (Moldova) Live 2010 Eurovision Song Contest
ZRnrjxDKv6Q	3rd Prototype - I Know [NCS Release]
ZSM3w1v-A_Y	Timbaland - Apologize ft. OneRepublic
2MiQonPvlVM	유빈(Yubin) "숙녀 (淑女)" M/V
7iNbnineUCI	The Offspring - The Kids Aren't Alright (Official Music Video)
tPqf69AjyJw	Jason Mraz - I won't give up (한국어 가사/해석/자막)
gnN_jiesIkM	Steal My Girl
rgjVbHeW8sc	Wicked Wonderland
OPGtpO1g_jk	OneRepublic - Didn’t I (Official Music Video)
eHsQ320W4aw	전 여자친구에게, Lauv - Julia [가사/해석/자막/lyrics]
YOrMAW4pKuA	OneRepublic - Better Days (Audio)
V9QXQz6uE0M	Wonder Girls(원더걸스) "I Feel You" M/V
nPvuNsRccVw	Bruno Mars - Treasure (Official Music Video)
9hFngJ07938	Tobu - Louder Now
bLCZ3_SK9e8	ONEUS (원어스) - 쉽게 쓰여진 노래 (A Song Written Easily) (Color Coded Lyrics Eng/Rom/Han/가사)
vBGiFtb8Rpw	Culture Code - Make Me Move (feat. Karra) [NCS Release]
TfSmlzMPrzU	Jim Yosef - Let You Go
qkP6Tf79UrM	To Build a Home - The Cinematic Orchestra (Lyrics)
7i0gz1sVs4w	William Black - Deep Blue (Lyrics) ft. Monika Santucci
SywgDfYoROE	Simple Plan - Save You (lyrics)
lDHjd-X1Tvk	[한글번역] Celldweller - Jericho
xwnkddO5WgM	[한글번역] Matryoshka - Rusty Sky
qi1uf0iUCuY	MJ (써니사이드) - 그 시절, 내가 좋아했던 [feat. 김꽃] (Official Audio)
FpVMij52naQ	Illenium - Needed You (ft. Dia Frampton) [LYRICS]
8yGKJl_U4Gg	Axwell Λ Ingrosso - More Than You Know (Lyrics)
GLJYZ8ySAas	Vicetone - Feels Like (Official Video) ft. LAUR
r1Fx0tqK5Z4	Sasha Alex Sloan - Older (Lyric Video)
R4wbjdrbDa4	tomorrow tonight
wN83dn07TUw	DAISHI DANCE, Cecile Corbel - Take Me Hand (Lyrics)
nGGogqJlB8Q	[한글자막] Moon Taxi - Two High
JzpxJcJwDZ0	Zedd & Jasmine Thompson - Funny (Lyric Video)
Z3NoQSWJIso	날 위해 무엇을 희생할 수 있니, Bebe Rexha - Sacrifice [가사/해석/번역/lyrics]
ePCUYMJQ03I	Zedd - Papercut 한글가사
p_vSh1DUsD4	The Chainsmokers - Do You Mean (Lyric Video) ft. Ty Dolla $ign, bülow
bsrzCB8-KHM	Jennifer Lopez - Brave, Lyrics In Video
UTNvKeNhyQk	[한글자막] Illenium & Kerli - Sound of Walking Away
oIWq4_OvQoQ	에미넴 랩으로 영화를 만든 Stan
MdxpTawWVPM	에미넴 추천 명곡 Beautiful
-Evy90LV8_s	[한글번역] Lauren Aquilina - Forest Fires
Hm8aP6ajqaw	Lukas Graham - Share That Love[가사/자막/해석]
4fggKUJM_fk	[한글번역] Fleurie - Hurricane
S6RShGLbg2w	Gryffin, Elley duhé - Tie me down [한글 / 번역 / 가사 , ENG- KOR Lyric Video]
3Nvkjr_UI_E	"The take over,The break's over" lyrics-Fall Out Boy
c7d_nX6ZmYU	LOVA - Dance For The Hell Of It (Lyrics)
KZIyyb6z-CY	Hearts & Colors - LA On A Saturday Night
lKcAQoyOQOw	Best Of Loving Caliber (Music)
w96vEK_i8jE	Misery Business - Pararmore - Lyrics
F2eRmK3TbXI	Homesick (feat. SOUNDR)
H-wn8HTNMTs	Tell Me It's Okay
9rOYHhgL3Lk	Last Party
rXHfIHkPMSA	The Best Of Me
f9iJFdSEuUs	Up & Up
SfnFNgzU_Zs	David Guetta - Let It Be Me 한글가사
4cbSPNZryzo	blink-182 - Darkside (Official Video)
eB32nBE73yI	25 To Life
06rgaTpTji0	No Sleep (feat. Bonn)
kB7i8T5PQwQ	These Are The Times
BxaR42Vy2LI	Carry On (from the Original Motion Picture "POKÉMON Detective Pikachu") (Official Video)
K0Xx6vd3YXc	Running To The Edge
tgZ2txcaBmc	are you sure?
WRx68ipjUBI	Axel Johansson feat. Tina Stachowiak - Next To Me (Official Video)
AW3RspM7v9M	Boys Like Girls - Two Is Better Than One
Lpjcm1F8tY8	Martin Garrix feat. Bonn - High On Life (Official Video)
quQNo3kxFQQ	Bring Me Back
QKT2I9oCM2Q	Tritonal - Good Thing ft. Laurell (Official Music Video)
zf_2xl4PMJ4	Cool
t3WrWp_C7DI	Dance
UyebyTbqFMY	Tiny Riot
rIGAt5yvfmw	Torn
kOy2Lt2-foU	For You (Fifty Shades Freed)
EDRBluZnyys	Scars To Your Beautiful
UNAr5tzZxdk	Cartoons - Witch Doctor
_aIDzESLNWc	Wrong (feat. Emilia Ali)
m3YZ0l0l1Q8	Why Do I?
8PTDv_szmL0	B.o.B - Nothin' On You (feat. Bruno Mars) [Official Video]
S9djownxlYg	Love Me Now
ZAYZmIfHEiU	Passenger | Home (Official Album Audio)
orJSJGHjBLI	Ed Sheeran - Bad Habits [Official Video]
9bljFUfIshM	Avicii - Sunset Jesus (Lyric Video)
XxwhwIhQq2s	September Song
RQUuqbzQVsY	Liam Payne, Rita Ora - For You (Fifty Shades Freed) (Official Music Video)
hR746y2nDsg	Someone You Hate
njvA03rMHx4	Safe And Sound
np30lwvSoPY	Kiss It Better
-KBh3fm6gFo	Lennon Stella - Older Than I Am (Official Video)
SqK_9tpt_SY	Normal
_TWn9jBVCc4	Porter Robinson - Everything Goes On 한글가사
tcOrf0M1PZA	[한글자막] ItaloBrothers - Till You Drop
QvA0ZTKZsXM	SawanoHiroyuki[nZk] ReoNa『time』LIVE
u6fQ9q9j-Qk	Maps
eZCWyFNV_ZM	Sunroof
TVoVMXMKpwc	Lost Without You (with Dean Lewis)
pjTj-_55WZ8	Rudimental - These Days (feat. Jess Glynne, Macklemore & Dan Caplen) [Official Video]
6OLp72eLLc4	Bastille - Million Pieces ft. The Chamber Orchestra Of London (Live)
SRgXX80ljSw	[Official] Tok! Tok! Tok! - LENA
4FwfrXDAFyA	wimp ft. Lil' Fang (from FAKY)
C0USKQRvuIc	디스코 (D.I.S.C.O) ft. T.O.P
3YqPKLZF_WU	Coldplay X BTS - My Universe (Official Video)
6fPMhFkR28U	かくれんぼ
IwQGnXpskoY	ただ声一つ
JXkySkXDHgM	Close To The Sun
eAOvikzmuGQ	Celestial
Mdojg6dWxQQ	The Gate of the Hell
oIscL-Bjsq4	The End Of Evangelion - Komm Süsser Tod
cvxm8GJJHqQ	✿心做し/花たん(cover)


531